"Player","Season","Progressive_Passes_Received","TakeOn_Attempts","TakeOn_Successful","TakeOn_Success_Percentage","TakeOn_Tackled","TakeOn_Tackled_Percentage","Tackles_Total","Tackles_Won","Tackles_Defensive_Third","Tackles_Middle_Third","Tackles_Attacking_Third","Challenges_Tackled","Challenges_Attempts","Challenges_Tackle_Percentage","Challenges_Lost","Ball_Blocks","Shot_Blocks","Pass_Blocks","Interceptions","Tackles_Plus_Interceptions","Clearances","Errors_Leading_to_Shot","Aerials_Won","Aerials_Lost","Aerial_Win_Percentage","Position"
"Fabinho","2017-2018",57,51,37,72.5,14,27.5,114,64,38,67,9,48,112,42.9,64,48,13,35,43,157,62,0,94,45,67.6,"MF"
"Rachid Ghezzal","2017-2018",127,55,29,52.7,26,47.3,31,24,6,22,3,7,34,20.6,27,17,0,17,11,42,2,1,9,22,29,"FW,MF"
"Nampalys Mendy","2017-2018",6,4,3,75,1,25,13,6,8,5,0,5,17,29.4,12,9,1,8,13,26,10,1,3,3,50,"MF"
"Max Gradel","2017-2018",316,143,79,55.2,64,44.8,63,36,28,21,14,24,72,33.3,48,39,2,37,14,77,30,0,13,50,20.6,"FW,MF"
"Issa Diop","2017-2018",1,15,11,73.3,4,26.7,58,43,35,22,1,21,48,43.8,27,38,25,13,76,134,128,0,57,36,61.3,"DF"
"Dimitri Foulquier","2017-2018",30,54,33,61.1,21,38.9,25,12,15,8,2,7,17,41.2,10,15,4,11,14,39,33,0,5,8,38.5,"DF"
"Yves Bissouma","2017-2018",51,75,55,73.3,20,26.7,67,50,30,32,5,19,39,48.7,20,13,2,11,31,98,31,1,22,11,66.7,"MF,DF"
"Adama Diakhaby","2017-2018",82,25,5,20,20,80,23,15,6,12,5,6,16,37.5,10,13,0,13,13,36,5,0,15,27,35.7,"FW"
"Isaac Mbenza","2017-2018",179,35,22,62.9,13,37.1,16,11,4,8,4,6,16,37.5,10,8,1,7,4,20,5,0,7,11,38.9,"FW,MF"
"João Moutinho","2017-2018",76,29,21,72.4,8,27.6,65,41,19,37,9,27,80,33.8,53,52,12,40,36,101,54,0,25,24,51,"MF"
"Prince Oniangué","2017-2018",22,9,7,77.8,2,22.2,16,11,5,9,2,8,31,25.8,23,20,4,16,11,27,8,0,39,55,41.5,"MF"
"Maxime Le Marchand","2017-2018",69,24,17,70.8,7,29.2,48,36,28,18,2,20,41,48.8,21,36,13,23,65,113,105,4,51,23,68.9,"DF"
"Youri Tielemans","2017-2018",60,43,24,55.8,19,44.2,47,24,14,28,5,17,55,30.9,38,24,5,19,34,81,20,1,24,21,53.3,"MF"
"Emiliano Sala","2017-2018",223,53,28,52.8,24,45.3,19,11,3,9,7,5,33,15.2,28,27,3,24,9,28,50,0,119,200,37.3,"FW"
"Yuri Berchiche","2017-2018",145,16,12,75,4,25,39,27,21,11,7,12,25,48,13,15,2,13,24,63,53,0,39,17,69.6,"DF"
"Thomas Lemar","2017-2018",163,89,46,51.7,44,49.4,33,17,9,19,5,10,41,24.4,31,22,1,21,18,51,16,1,7,15,31.8,"MF,FW"
"Malcom","2017-2018",272,141,93,66,48,34,15,10,3,7,5,1,28,3.6,27,13,1,12,14,29,6,0,18,49,26.9,"FW"
"Marlon","2017-2018",3,11,9,81.8,2,18.2,36,26,22,13,1,15,22,68.2,7,19,15,4,15,51,72,2,37,23,61.7,"DF"
"Júnior Alonso","2017-2018",14,18,15,83.3,3,16.7,58,31,36,22,0,28,50,56,22,26,16,10,56,114,153,1,91,43,67.9,"DF"
"Giovani Lo Celso","2017-2018",56,67,47,70.1,20,29.9,77,58,26,36,15,26,74,35.1,48,30,5,25,19,96,12,1,5,13,27.8,"MF"
"Ibrahim Amadou","2017-2018",19,13,11,84.6,2,15.4,43,29,24,19,0,14,27,51.9,13,30,13,17,41,84,70,3,33,27,55,"MF,DF"
"Joris Gnagnon","2017-2018",7,7,7,100,0,0,42,29,29,9,4,21,31,67.7,10,22,16,6,29,71,154,2,70,35,66.7,"DF"
"Mouctar Diakhaby","2017-2018",0,7,7,100,0,0,10,6,7,3,0,4,7,57.1,3,14,9,5,12,22,52,1,21,13,61.8,"DF"
"Karl Toko Ekambi","2017-2018",352,131,66,50.4,65,49.6,17,8,2,5,10,5,29,17.2,24,13,0,13,15,32,2,0,28,78,26.4,"FW,MF"
"Keita Baldé","2017-2018",139,46,30,65.2,16,34.8,12,8,5,6,1,1,11,9.1,10,10,1,9,6,18,5,0,15,28,34.9,"FW,MF"
"Kévin Malcuit","2017-2018",114,96,57,59.4,39,40.6,51,37,31,16,4,17,25,68,8,13,5,8,38,89,47,0,13,12,52,"DF"
"Javier Pastore","2017-2018",131,42,27,64.3,15,35.7,33,21,9,16,8,5,23,21.7,18,13,0,13,10,43,14,1,4,8,33.3,"MF,FW"
"Soualiho Meïté","2017-2018",46,50,35,70,15,30,27,14,5,20,2,11,37,29.7,26,23,6,17,26,53,16,1,29,19,60.4,"MF"
"Koffi Djidji","2017-2018",24,15,12,80,3,20,55,39,32,20,3,19,29,65.5,10,34,15,19,45,100,126,0,37,19,66.1,"DF"
"Assane Dioussé","2017-2018",26,15,13,86.7,2,13.3,32,21,14,14,4,13,34,38.2,21,29,2,27,11,43,16,2,10,15,40,"MF"
"Lukas Lerager","2017-2018",97,14,8,57.1,6,42.9,107,74,33,61,13,33,107,30.8,74,44,8,36,67,174,66,1,99,75,56.9,"MF"
"Hamza Mendyl","2017-2018",41,24,12,50,12,50,18,10,12,6,0,11,20,55,9,5,0,5,17,35,26,0,6,9,40,"DF,MF"
"Nordi Mukiele","2017-2018",80,63,41,65.1,22,34.9,70,55,41,25,4,25,44,56.8,19,26,14,12,73,143,104,2,71,34,67.6,"DF"
"Fallou Diagne","2017-2018",12,9,8,88.9,1,11.1,33,20,21,12,0,7,22,31.8,15,33,18,15,46,79,116,3,62,30,67.4,"DF,MF"
"Jérôme Roussillon","2017-2018",125,72,37,51.4,35,48.6,40,27,17,19,4,15,26,57.7,11,26,3,23,15,55,52,0,11,16,40.7,"DF"
"Paul-Georges Ntep","2017-2018",58,21,14,66.7,7,33.3,14,8,8,5,1,8,17,47.1,9,4,1,3,3,17,4,0,5,8,38.5,"FW,MF"
"Almamy Touré","2017-2018",76,19,13,68.4,6,31.6,51,29,31,13,7,18,30,60,12,15,2,13,22,73,61,0,32,22,59.3,"DF"
"Manu García","2018-2019",65,58,32,55.2,26,44.8,37,26,14,17,6,15,49,30.6,34,16,1,15,15,52,5,0,3,14,17.6,"MF"
"Sheyi Ojo","2018-2019",47,23,8,34.8,15,65.2,8,6,2,4,2,2,8,25,6,1,0,1,3,11,2,0,4,16,20,"FW,MF"
"Michael Hector","2018-2019",7,25,21,84,4,16,79,47,51,28,0,30,58,51.7,28,63,28,35,55,134,208,5,127,73,63.5,"DF"
"Jack Clarke","2018-2019",104,47,26,55.3,21,44.7,13,9,2,7,4,3,7,42.9,4,10,0,10,3,16,4,0,5,17,22.7,"MF,FW"
"Nicolas Pépé","2018-2019",293,182,101,55.5,81,44.5,27,10,6,15,6,8,35,22.9,27,33,0,33,13,40,11,1,42,37,53.2,"FW,MF"
"William Saliba","2018-2019",4,12,9,75,3,25,32,20,28,4,0,16,24,66.7,8,11,10,1,28,60,44,2,28,19,59.6,"DF"
"Daniel James","2018-2019",391,76,44,57.9,32,42.1,26,20,9,12,5,8,19,42.1,11,20,0,20,7,33,13,1,14,40,25.9,"FW,MF"
"Djibril Sidibé","2018-2019",166,32,8,25,24,75,50,34,27,12,11,26,48,54.2,22,25,9,16,30,80,51,0,30,26,53.6,"DF,MF"
"Youri Tielemans","2018-2019",41,35,18,51.4,17,48.6,45,24,17,23,5,24,47,51.1,23,20,3,17,18,63,22,0,27,17,61.4,"MF"
"Craig Dawson","2018-2019",8,5,4,80,1,20,51,37,32,17,2,26,40,65,14,45,34,11,65,116,147,6,180,94,65.7,"DF"
"Allan Saint-Maximin","2018-2019",309,252,143,56.7,109,43.3,12,6,1,7,4,2,14,14.3,12,11,0,11,4,16,3,0,30,31,49.2,"FW"
"Emil Krafth","2018-2019",74,22,8,36.4,14,63.6,55,35,34,14,7,32,65,49.2,33,27,12,15,23,78,94,4,42,32,56.8,"DF"
"Lloyd Kelly","2018-2019",78,51,30,58.8,21,41.2,42,28,32,9,1,15,20,75,5,21,6,15,31,73,93,1,76,53,58.9,"DF"
"Erik Pieters","2018-2019",23,15,7,46.7,8,53.3,49,28,28,18,3,25,33,75.8,8,21,13,8,17,66,56,0,21,21,50,"DF"
"Erik Pieters","2018-2019",37,10,5,50,5,50,49,32,33,14,2,16,29,55.2,13,30,7,23,33,82,88,0,44,32,57.9,"DF"
"Adam Webster","2018-2019",19,29,21,72.4,8,27.6,61,36,39,18,4,20,36,55.6,16,64,35,29,91,152,190,0,278,109,71.8,"DF"
"Neal Maupay","2018-2019",287,80,31,38.8,49,61.3,31,17,11,13,7,4,28,14.3,24,25,1,24,8,39,7,0,25,82,23.4,"FW"
"Oliver McBurnie","2018-2019",235,77,38,49.4,39,50.6,38,23,10,22,6,9,36,25,27,25,5,20,17,55,52,1,126,160,44.1,"FW,MF"
"Callum Robinson","2018-2019",164,52,36,69.2,16,30.8,12,6,6,4,2,6,18,33.3,12,19,1,18,13,25,16,0,12,45,21.1,"FW,MF"
"Luke Freeman","2018-2019",217,124,69,55.6,55,44.4,45,30,15,23,7,12,39,30.8,27,30,6,24,50,95,41,2,22,65,25.3,"MF,FW"
"Ben Osborn","2018-2019",162,27,13,48.1,14,51.9,70,36,47,18,5,28,58,48.3,30,50,5,45,32,102,40,0,36,57,38.7,"DF,FW"
"Ezri Konsa","2018-2019",9,23,16,69.6,7,30.4,50,34,25,24,1,27,38,71.1,11,34,20,14,46,96,156,1,82,67,55,"DF"
"Anwar El Ghazi","2018-2019",220,63,33,52.4,30,47.6,27,21,9,12,6,9,23,39.1,14,17,2,15,8,35,14,0,29,57,33.7,"MF,FW"
"Björn Engels","2018-2019",4,10,6,60,4,40,11,8,6,5,0,6,16,37.5,10,30,24,6,44,55,181,3,99,49,66.9,"DF"
"Gary Gardner","2018-2019",44,31,21,67.7,10,32.3,87,57,28,53,6,42,83,50.6,41,52,10,42,45,132,54,2,102,64,61.4,"MF"
"Jack Clarke","2018-2019",104,47,26,55.3,21,44.7,13,9,2,7,4,3,7,42.9,4,10,0,10,3,16,4,0,5,17,22.7,"MF,FW"
"Cameron Carter-Vickers","2018-2019",1,5,4,80,1,20,25,14,18,6,1,5,9,55.6,4,18,12,6,37,62,115,1,95,58,62.1,"DF"
"Kieran Dowell","2018-2019",58,11,6,54.5,5,45.5,8,7,3,1,4,3,15,20,12,4,0,4,7,15,10,0,7,17,29.2,"MF,DF"
"Jarrod Bowen","2018-2019",243,123,66,53.7,57,46.3,66,41,27,28,11,17,54,31.5,37,49,4,45,49,115,48,0,31,91,25.4,"MF,FW"
"Josh Brownhill","2018-2019",129,52,31,59.6,21,40.4,62,33,25,31,6,18,43,41.9,25,40,12,28,61,123,70,2,88,53,62.4,"MF"
"Nahki Wells","2018-2019",248,81,30,37,50,61.7,38,24,13,17,8,9,36,25,27,23,2,21,6,44,11,0,54,105,34,"FW"
"Jack Robinson","2018-2019",81,22,16,72.7,6,27.3,75,49,50,21,4,24,45,53.3,21,46,13,33,45,120,170,3,120,98,55,"DF"
"Mark Duffy","2018-2019",269,61,43,70.5,18,29.5,52,30,15,23,14,18,47,38.3,29,36,1,35,15,67,14,0,29,63,31.5,"MF"
"Scott Hogan","2018-2019",29,7,1,14.3,6,85.7,0,0,0,0,0,0,8,0,8,6,0,6,1,1,0,0,3,37,7.5,"FW"
"James Chester","2018-2019",0,6,4,66.7,2,33.3,28,11,23,5,0,15,22,68.2,7,27,16,11,24,52,182,1,104,67,60.8,"DF"
"Sergi Palencia","2018-2019",82,29,12,41.4,17,58.6,74,50,46,20,8,27,55,49.1,28,22,3,19,17,91,70,1,19,41,31.7,"DF"
"Gelson Martins","2018-2019",152,53,25,47.2,28,52.8,20,12,8,7,5,13,32,40.6,19,9,1,8,8,28,7,0,7,19,26.9,"FW,MF"
"Ferland Mendy","2018-2019",212,72,55,76.4,17,23.6,44,28,25,14,5,14,17,82.4,3,22,5,17,34,78,53,2,46,36,56.1,"DF"
"Fayçal Fajr","2018-2019",59,47,29,61.7,18,38.3,65,32,22,33,10,25,66,37.9,41,27,6,21,29,94,19,2,15,21,41.7,"MF"
"Jules Koundé","2018-2019",3,15,13,86.7,2,13.3,48,31,37,11,0,27,41,65.9,14,44,23,21,50,98,193,7,116,88,56.9,"DF"
"Rony Lopes","2018-2019",168,62,28,45.2,34,54.8,33,22,10,17,6,9,22,40.9,13,17,1,16,8,41,10,0,7,21,25,"FW,MF"
"Lucas Ocampos","2018-2019",210,138,66,47.8,72,52.2,80,54,37,33,10,34,80,42.5,46,40,5,35,29,109,30,0,39,56,41.1,"FW,MF"
"Diego Carlos","2018-2019",9,8,6,75,2,25,58,34,43,14,1,26,33,78.8,7,44,31,13,50,108,186,1,86,69,55.5,"DF"
"Martin Braithwaite","2018-2019",97,23,16,69.6,7,30.4,7,6,2,3,2,1,4,25,3,14,0,14,6,13,12,0,13,27,32.5,"FW"
"Nabil Fekir","2018-2019",175,82,47,57.3,35,42.7,51,31,16,19,16,13,38,34.2,25,42,0,42,7,58,3,0,13,31,29.5,"MF"
"Claudio Beauvue","2018-2019",116,26,10,38.5,16,61.5,18,11,7,9,2,1,14,7.1,13,11,2,9,10,28,21,0,64,77,45.4,"FW,MF"
"Ante Budimir","2018-2019",109,15,9,60,6,40,8,7,1,3,4,1,8,12.5,7,10,1,9,0,8,8,0,42,46,47.7,"FW,MF"
"Yannis Salibur","2018-2019",88,37,26,70.3,11,29.7,9,5,1,7,1,1,7,14.3,6,6,0,6,8,17,4,0,9,17,34.6,"FW,MF"
"Pablo Chavarría","2018-2019",141,25,10,40,15,60,20,12,8,6,6,3,15,20,12,11,0,11,4,24,19,0,74,112,39.8,"FW"
"Aleksandar Trajkovski","2018-2019",321,111,51,45.9,60,54.1,28,20,11,13,4,7,22,31.8,15,20,3,17,19,47,7,0,8,18,30.8,"MF"
"Bruno Martella","2018-2019",114,23,16,69.6,7,30.4,23,14,9,8,6,10,18,55.6,8,20,8,12,26,49,65,0,30,18,62.5,"DF"
"Mario Balotelli","2018-2019",98,32,13,40.6,19,59.4,6,3,1,4,1,3,11,27.3,8,17,3,14,4,10,14,0,34,44,43.6,"FW"
"Lukas Lerager","2018-2019",22,4,2,50,2,50,38,21,14,23,1,18,43,41.9,25,22,10,12,32,70,26,1,24,25,49,"MF"
"Antonio Barreca","2018-2019",29,10,2,20,8,80,11,8,8,3,0,7,11,63.6,4,3,2,1,7,18,18,0,11,12,47.8,"DF"
"Samuel Di Carmine","2018-2019",134,2,2,100,0,0,5,4,2,2,1,1,4,25,3,3,0,3,5,10,21,0,39,37,51.3,"FW"
"Davide Faraoni","2018-2019",189,41,17,41.5,24,58.5,66,46,40,18,8,20,31,64.5,11,32,9,23,49,115,60,1,16,20,44.4,"DF,MF"
"Adrien Rabiot","2018-2019",24,22,15,68.2,7,31.8,35,20,13,17,5,9,12,75,3,9,2,7,10,45,20,0,20,10,66.7,"MF"
"Panagiotis Tachtsidis","2018-2019",13,6,5,83.3,1,16.7,25,21,12,10,3,12,31,38.7,19,16,5,11,27,52,30,0,33,14,70.2,"MF"
"Biagio Meccariello","2018-2019",21,15,9,60,6,40,47,34,32,15,0,18,40,45,22,33,17,16,68,115,166,1,54,22,71.1,"DF"
"Andrea Rispoli","2018-2019",87,13,5,38.5,8,61.5,21,15,10,6,5,12,16,75,4,11,3,8,27,48,41,0,22,19,53.7,"DF"
"Rafael Leão","2018-2019",76,17,9,52.9,8,47.1,5,2,0,4,1,2,15,13.3,13,13,4,9,4,9,12,0,27,56,32.5,"FW"
"Kastriot Dermaku","2018-2019",7,1,1,100,0,0,33,23,19,14,0,12,25,48,13,41,32,9,51,84,162,0,86,38,69.4,"DF"
"Tommaso Augello","2018-2019",174,62,42,67.7,20,32.3,23,17,17,4,2,7,17,41.2,10,24,4,20,46,69,77,0,37,15,71.2,"DF"
"Davide Mazzocco","2018-2019",55,17,13,76.5,4,23.5,41,26,21,17,3,15,32,46.9,17,14,4,10,7,48,24,0,46,34,57.5,"MF,DF"
"Ilija Nestorovski","2018-2019",194,19,9,47.4,10,52.6,13,10,5,5,3,1,7,14.3,6,10,1,9,3,16,13,0,26,59,30.6,"FW"
"Mato Jajalo","2018-2019",64,71,58,81.7,13,18.3,80,50,36,31,13,23,58,39.7,35,36,9,27,44,124,46,0,22,22,50,"MF"
"Adama Soumaoro","2018-2019",1,8,6,75,2,25,14,11,12,2,0,4,6,66.7,2,21,18,3,21,35,92,1,39,26,60,"DF"
"Emanuele Cicerelli","2018-2019",80,35,22,62.9,13,37.1,26,14,14,9,3,11,23,47.8,12,15,2,13,9,35,17,0,5,6,45.5,"MF,DF"
"Christopher Nkunku","2018-2019",130,39,23,59,16,41,21,16,8,10,3,7,16,43.8,9,12,2,10,9,30,7,1,11,15,42.3,"MF,FW"
"Moussa Diaby","2018-2019",148,36,20,55.6,16,44.4,14,8,7,2,5,2,11,18.2,9,7,1,6,12,26,6,0,2,9,18.2,"MF,DF"
"Marcus Thuram","2018-2019",221,146,101,69.2,45,30.8,45,28,23,15,7,20,43,46.5,23,24,1,23,10,55,14,0,110,93,54.2,"FW,MF"
"Ramy Bensebaini","2018-2019",93,28,12,42.9,16,57.1,69,48,42,19,8,40,58,69,18,24,10,14,41,110,98,0,51,32,61.4,"DF"
"Ellyes Skhiri","2018-2019",52,43,32,74.4,11,25.6,105,58,31,64,10,43,91,47.3,48,60,7,53,60,165,41,0,40,30,57.1,"MF"
"Serhou Guirassy","2018-2019",93,24,9,37.5,15,62.5,7,5,1,5,1,0,4,0,4,7,0,7,4,11,14,0,91,59,60.7,"FW"
"Lucas Tousart","2018-2019",16,13,10,76.9,3,23.1,74,38,33,34,7,25,59,42.4,34,30,13,17,26,100,27,0,31,39,44.3,"MF"
"Toni Leistner","2018-2019",5,8,8,100,0,0,59,35,44,14,1,14,24,58.3,10,47,36,11,61,120,293,4,180,110,62.1,"DF"
"William Saliba","2019-2020",7,7,6,85.7,1,14.3,19,9,15,3,1,5,10,50,5,13,4,9,21,40,36,1,29,18,61.7,"DF"
"Ollie Watkins","2019-2020",401,63,39,61.9,24,38.1,28,16,5,12,11,8,35,22.9,27,33,4,29,14,42,18,0,99,150,39.8,"FW"
"Bertrand Traoré","2019-2020",132,62,33,53.2,29,46.8,27,14,8,12,7,8,19,42.1,11,17,2,15,21,48,16,0,15,19,44.1,"FW,MF"
"Matty Cash","2019-2020",169,67,43,64.2,24,35.8,110,82,75,29,6,57,91,62.6,34,39,14,25,57,167,170,0,74,66,52.9,"DF"
"James Bree","2019-2020",104,26,16,61.5,10,38.5,34,26,23,4,7,18,37,48.6,19,25,12,13,36,70,104,0,65,54,54.6,"DF"
"Scott Hogan","2019-2020",99,20,9,45,11,55,2,1,0,1,1,0,3,0,3,10,1,9,1,3,4,0,18,61,22.8,"FW"
"Anthony Knockaert","2019-2020",345,82,46,56.1,36,43.9,32,17,12,11,9,14,47,29.8,33,19,1,18,20,52,20,2,21,29,42,"FW"
"Ben White","2019-2020",6,39,29,74.4,10,25.6,74,46,48,26,0,24,47,51.1,23,53,25,28,116,190,128,0,127,116,52.3,"DF"
"Malang Sarr","2019-2020",2,3,3,100,0,0,19,11,13,6,0,9,22,40.9,13,10,4,6,38,57,31,4,13,16,44.8,"DF"
"Thiago Silva","2019-2020",1,3,2,66.7,1,33.3,28,16,15,13,0,13,16,81.3,3,18,15,3,26,54,54,0,30,18,62.5,"DF"
"Jake Clarke-Salter","2019-2020",2,7,6,85.7,1,14.3,27,15,18,9,0,12,18,66.7,6,32,23,9,23,50,77,0,69,60,53.5,"DF"
"Matt Miazga","2019-2020",4,2,1,50,1,50,19,11,16,2,1,11,18,61.1,7,18,14,4,11,30,91,2,79,42,65.3,"DF"
"Izzy Brown","2019-2020",70,76,49,64.5,27,35.5,31,18,11,14,6,11,32,34.4,21,7,0,7,14,45,10,0,21,33,38.9,"MF"
"Tiemoué Bakayoko","2019-2020",56,57,36,63.2,21,36.8,48,24,16,27,5,29,54,53.7,25,12,4,8,29,77,17,0,29,11,72.5,"MF"
"Izzy Brown","2019-2020",70,76,49,64.5,27,35.5,31,18,11,14,6,11,32,34.4,21,7,0,7,14,45,10,0,21,33,38.9,"MF"
"Jake Clarke-Salter","2019-2020",2,7,6,85.7,1,14.3,27,15,18,9,0,12,18,66.7,6,32,23,9,23,50,77,0,69,60,53.5,"DF"
"Eberechi Eze","2019-2020",221,222,136,61.3,86,38.7,54,32,15,30,9,24,56,42.9,32,32,1,31,24,78,11,0,29,63,31.5,"MF,FW"
"Nathan Ferguson","2019-2020",36,48,31,64.6,17,35.4,50,35,27,19,4,21,37,56.8,16,19,4,15,19,69,47,0,34,27,55.7,"DF"
"Connor Wickham","2019-2020",57,17,14,82.4,3,17.6,6,4,2,1,3,2,10,20,8,6,1,5,0,6,13,1,50,77,39.4,"FW"
"Kieran Dowell","2019-2020",93,22,17,77.3,5,22.7,27,17,8,14,5,7,35,20,28,19,0,19,9,36,3,0,11,23,32.4,"MF"
"Matthew Pennington","2019-2020",9,12,8,66.7,4,33.3,15,13,8,5,2,6,16,37.5,10,17,13,4,30,45,49,1,47,25,65.3,"DF"
"Terence Kongolo","2019-2020",22,4,2,50,2,50,27,15,20,5,2,9,16,56.3,7,11,7,4,16,43,32,0,24,10,70.6,"DF"
"Kenny Tete","2019-2020",88,20,11,55,9,45,33,21,12,16,5,15,23,65.2,8,12,3,9,19,52,34,0,10,10,50,"DF"
"Antonee Robinson","2019-2020",179,134,81,60.4,53,39.6,84,60,56,24,4,40,95,42.1,55,43,13,30,76,160,133,0,43,51,45.7,"DF"
"Joachim Andersen","2019-2020",1,3,3,100,0,0,17,9,15,2,0,7,19,36.8,12,16,12,4,10,27,74,2,50,22,69.4,"DF"
"Anthony Knockaert","2019-2020",345,82,46,56.1,36,43.9,32,17,12,11,9,14,47,29.8,33,19,1,18,20,52,20,2,21,29,42,"FW"
"Stefan Johansen","2019-2020",65,16,9,56.3,7,43.8,26,11,10,10,6,5,31,16.1,26,20,4,16,12,38,9,0,7,13,35,"MF"
"Neeskens Kebano","2019-2020",101,16,10,62.5,6,37.5,14,9,6,4,4,7,15,46.7,8,8,1,7,4,18,5,0,6,8,42.9,"FW"
"Steven Sessegnon","2019-2020",20,9,5,55.6,4,44.4,15,9,5,10,0,7,15,46.7,8,10,5,5,10,25,19,0,14,16,46.7,"DF"
"Cyrus Christie","2019-2020",60,20,13,65,7,35,33,20,20,11,2,17,25,68,8,16,6,10,20,53,54,0,30,35,46.2,"DF"
"Raphinha","2019-2020",155,112,49,43.8,63,56.3,22,18,5,12,5,10,32,31.3,22,23,1,22,17,39,14,1,14,22,38.9,"MF,FW"
"Barry Douglas","2019-2020",39,7,4,57.1,3,42.9,12,6,7,2,3,7,13,53.8,6,9,2,7,9,21,9,0,8,11,42.1,"DF"
"Wesley Fofana","2019-2020",4,8,3,37.5,5,62.5,25,15,16,9,0,12,18,66.7,6,10,5,5,36,61,55,4,62,24,72.1,"DF"
"Islam Slimani","2019-2020",142,20,8,40,12,60,8,4,0,2,6,4,15,26.7,11,5,0,5,1,9,11,1,49,46,51.6,"FW"
"Fousseni Diabaté","2019-2020",111,47,29,61.7,18,38.3,16,10,6,6,4,5,16,31.3,11,11,0,11,8,24,3,1,8,17,32,"FW,MF"
"Adrien Silva","2019-2020",21,31,21,67.7,10,32.3,37,22,14,19,4,10,37,27,27,19,6,13,12,49,14,2,10,16,38.5,"MF"
"Ovie Ejaria","2019-2020",121,171,111,64.9,60,35.1,50,25,15,29,6,10,39,25.6,29,30,5,25,52,102,31,1,26,50,34.2,"MF,FW"
"Patrick Roberts","2019-2020",42,41,20,48.8,21,51.2,4,2,1,0,3,1,4,25,3,0,0,0,1,5,1,0,0,9,0,"MF,FW"
"Jack Harrison","2019-2020",464,144,85,59,59,41,48,26,17,17,14,18,60,30,42,40,2,38,22,70,24,3,25,60,29.4,"MF,FW"
"Lukas Nmecha","2019-2020",37,15,9,60,6,40,7,6,0,3,4,1,3,33.3,2,4,0,4,6,13,3,0,5,13,27.8,"FW,MF"
"Patrick Roberts","2019-2020",42,41,20,48.8,21,51.2,4,2,1,0,3,1,4,25,3,0,0,0,1,5,1,0,0,9,0,"MF,FW"
"Tosin Adarabioyo","2019-2020",7,12,10,83.3,2,16.7,30,17,19,8,3,7,19,36.8,12,30,26,4,64,94,166,1,108,46,70.1,"DF"
"Edinson Cavani","2019-2020",52,8,7,87.5,1,12.5,5,1,0,2,3,0,3,0,3,7,0,7,1,6,2,0,4,7,36.4,"FW"
"Jacob Murphy","2019-2020",147,116,68,58.6,48,41.4,30,22,11,12,7,14,33,42.4,19,25,1,24,12,42,17,0,20,41,32.8,"MF,FW"
"Jayden Bogle","2019-2020",177,111,63,56.8,48,43.2,65,43,46,14,5,30,54,55.6,24,26,11,15,37,102,62,2,28,35,44.4,"DF"
"Max Lowe","2019-2020",104,61,40,65.6,21,34.4,106,60,68,31,7,32,63,50.8,31,34,9,25,47,153,63,0,44,38,53.7,"DF"
"Callum Robinson","2019-2020",92,20,12,60,8,40,11,5,6,5,0,4,15,26.7,11,5,1,4,9,20,5,0,10,20,33.3,"FW"
"Ibrahima Diallo","2019-2020",18,32,26,81.3,6,18.8,38,24,15,22,1,12,29,41.4,17,9,2,7,23,61,16,3,15,11,57.7,"MF"
"Harrison Reed","2019-2020",17,15,11,73.3,4,26.7,47,23,27,16,4,16,49,32.7,33,13,5,8,35,82,33,0,23,33,41.1,"MF"
"Joe Rodon","2019-2020",1,2,1,50,1,50,22,14,15,7,0,14,22,63.6,8,29,22,7,33,55,114,1,73,50,59.3,"DF"
"Cameron Carter-Vickers","2019-2020",33,10,5,50,5,50,33,25,23,7,3,10,15,66.7,5,27,19,8,35,68,136,0,86,36,70.5,"DF"
"Karlan Grant","2019-2020",315,110,46,41.8,64,58.2,18,12,8,6,4,4,23,17.4,19,16,0,16,19,37,24,0,37,101,26.8,"FW"
"Cédric Kipré","2019-2020",6,9,6,66.7,3,33.3,50,35,32,16,2,23,27,85.2,4,44,27,17,56,106,144,0,70,52,57.4,"DF"
"Charlie Austin","2019-2020",94,16,10,62.5,6,37.5,9,8,3,2,4,4,15,26.7,11,8,2,6,2,11,28,0,27,77,26,"FW"
"Kenneth Zohore","2019-2020",46,10,6,60,4,40,3,3,0,3,0,1,3,33.3,2,6,0,6,1,4,7,0,15,37,28.8,"FW"
"Sam Field","2019-2020",2,3,3,100,0,0,22,18,7,13,2,4,19,21.1,15,14,5,9,27,49,22,0,14,13,51.9,"MF"
"Sam Field","2019-2020",2,3,3,100,0,0,22,18,7,13,2,4,19,21.1,15,14,5,9,27,49,22,0,14,13,51.9,"MF"
"Saïd Benrahma","2019-2020",376,238,132,55.5,106,44.5,46,28,24,17,5,11,47,23.4,36,15,0,15,9,55,6,1,6,11,35.3,"FW"
"Grady Diangana","2019-2020",234,129,73,56.6,54,41.9,28,19,16,12,0,10,27,37,17,34,1,33,7,35,6,0,16,35,31.4,"FW"
"Josh Cullen","2019-2020",47,32,24,75,8,25,67,30,32,34,1,24,50,48,26,32,15,17,45,112,49,0,39,45,46.4,"MF"
"Jordan Hugill","2019-2020",145,27,15,55.6,12,44.4,11,6,2,6,3,4,15,26.7,11,25,6,19,1,12,30,0,135,161,45.6,"FW"
"Hélder Costa","2019-2020",376,126,59,46.8,67,53.2,63,37,23,23,17,15,66,22.7,51,30,1,29,13,76,25,0,16,48,25,"MF,FW"
"Morgan Sanson","2019-2020",142,64,40,62.5,24,37.5,60,28,20,29,11,13,52,25,39,39,5,34,23,83,9,0,13,36,26.5,"MF"
"Josh Maja","2019-2020",58,17,11,64.7,6,35.3,5,2,0,2,3,1,10,10,9,8,4,4,1,6,3,0,5,25,16.7,"FW"
"Alfie Mawson","2019-2020",4,6,6,100,0,0,17,14,8,8,1,7,14,50,7,33,25,8,23,40,96,1,90,46,66.2,"DF"
"Ben Davies","2019-2020",0,2,1,50,1,50,31,17,23,8,0,12,17,70.6,5,42,34,8,30,61,168,4,115,84,57.8,"DF"
"Patrick Roberts","2019-2020",42,41,20,48.8,21,51.2,4,2,1,0,3,1,4,25,3,0,0,0,1,5,1,0,0,9,0,"MF,FW"
"Saïd Benrahma","2019-2020",376,238,132,55.5,106,44.5,46,28,24,17,5,11,47,23.4,36,15,0,15,9,55,6,1,6,11,35.3,"FW"
"Joris Gnagnon","2019-2020",3,4,4,100,0,0,16,13,14,2,0,10,11,90.9,1,21,17,4,18,34,61,0,53,30,63.9,"DF"
"Karl Toko Ekambi","2019-2020",58,14,8,57.1,6,42.9,5,2,0,1,4,3,5,60,2,2,0,2,5,10,1,0,9,14,39.1,"FW,MF"
"Álvaro González","2019-2020",0,3,3,100,0,0,19,13,14,4,1,9,13,69.2,4,7,4,3,18,37,65,0,35,22,61.4,"DF"
"Moses Simon","2019-2020",232,81,36,44.4,45,55.6,15,7,5,4,6,6,21,28.6,15,6,0,6,8,23,6,0,9,39,18.8,"FW,MF"
"Álvaro Giménez","2019-2020",98,21,12,57.1,9,42.9,16,11,3,4,9,1,10,10,9,9,0,9,6,22,6,0,45,54,45.5,"FW"
"Youssouf Koné","2019-2020",26,22,16,72.7,6,27.3,22,14,17,3,2,12,20,60,8,2,1,1,8,30,15,0,6,7,46.2,"DF"
"Moussa Dembélé","2019-2020",134,60,24,40,36,60,12,7,2,5,5,4,14,28.6,10,14,3,11,5,17,31,0,68,75,47.6,"FW"
"Federico Barba","2019-2020",22,3,2,66.7,1,33.3,16,11,11,4,1,6,10,60,4,13,7,6,16,32,58,1,20,12,62.5,"DF"
"Gabriele Zappa","2019-2020",182,46,25,54.3,21,45.7,36,23,22,10,4,14,32,43.8,18,38,8,30,22,58,58,0,27,30,47.4,"DF,MF"
"Emmanuel Rivière","2019-2020",152,26,17,65.4,9,34.6,6,4,0,3,3,0,12,0,12,11,4,7,1,7,21,0,84,123,40.6,"FW"
"Victor Osimhen","2019-2020",148,38,15,39.5,23,60.5,8,4,1,0,7,1,11,9.1,10,8,0,8,11,19,32,0,109,142,43.4,"FW"
"Wylan Cyprien","2019-2020",28,23,14,60.9,9,39.1,17,11,5,12,0,7,27,25.9,20,8,2,6,19,36,16,3,14,10,58.3,"MF"
"Keita Baldé","2019-2020",78,8,5,62.5,3,37.5,6,5,1,1,4,3,9,33.3,6,4,1,3,2,8,7,1,25,35,41.7,"FW,MF"
"M'Bala Nzola","2019-2020",150,65,32,49.2,33,50.8,11,8,3,6,2,5,19,26.3,14,16,2,14,4,15,13,0,48,77,38.4,"FW"
"Jean-Victor Makengo","2019-2020",43,29,13,44.8,16,55.2,14,11,3,10,1,4,13,30.8,9,7,1,6,3,17,5,1,3,16,15.8,"MF"
"Fernando Forestieri","2019-2020",46,29,17,58.6,12,41.4,24,18,9,7,8,8,10,80,2,6,1,5,4,28,4,0,8,15,34.8,"FW,MF"
"Adama Soumaoro","2019-2020",0,1,1,100,0,0,1,1,0,1,0,0,0,NA,0,6,5,1,4,5,17,0,10,4,71.4,"DF"
"Youssef Maleh","2019-2020",135,35,21,60,14,40,58,39,25,20,13,21,42,50,21,35,4,31,27,85,28,0,22,33,40,"MF"
"Kevin Strootman","2019-2020",20,5,3,60,2,40,39,27,13,23,3,20,49,40.8,29,16,1,15,17,56,24,0,28,30,48.3,"MF"
"Bouna Sarr","2019-2020",142,86,49,57,37,43,60,37,30,19,11,30,53,56.6,23,17,1,16,32,92,38,0,41,37,52.6,"DF,FW"
"Tanguy Nianzou","2019-2020",2,4,3,75,1,25,2,1,0,1,1,1,3,33.3,2,4,2,2,3,5,6,0,13,4,76.5,"DF,MF"
"Eric Maxim Choupo-Moting","2019-2020",45,13,9,69.2,4,30.8,12,9,3,4,5,4,8,50,4,3,0,3,1,13,3,0,2,8,20,"FW,MF"
"Jude Bellingham","2019-2020",113,76,46,60.5,30,39.5,90,57,40,35,15,33,68,48.5,35,50,3,47,30,120,41,0,43,69,38.4,"MF,FW"
"Thomas Meunier","2019-2020",149,16,9,56.3,7,43.8,27,21,9,12,6,16,26,61.5,10,17,5,12,18,45,19,1,17,10,63,"DF"
"Benjamin Henrichs","2019-2020",49,14,8,57.1,6,42.9,26,20,16,9,1,14,33,42.4,19,19,4,15,14,40,18,0,7,7,50,"DF,MF"
"Baptiste Santamaria","2019-2020",16,42,31,73.8,11,26.2,91,53,39,43,9,35,79,44.3,44,27,5,22,43,134,36,0,53,39,57.6,"MF"
"Lucas Tousart","2019-2020",32,24,15,62.5,9,37.5,58,32,19,34,5,17,56,30.4,39,19,7,12,31,89,27,1,46,40,53.5,"MF"
"Hamza Mendyl","2019-2020",52,48,21,43.8,27,56.3,49,32,31,14,4,29,46,63,17,16,4,12,23,72,47,0,4,19,17.4,"DF"
"Mike van der Hoorn","2019-2020",4,7,7,100,0,0,22,16,14,8,0,11,22,50,11,21,16,5,23,45,111,0,84,53,61.3,"DF"
"Chadrac Akolo","2019-2020",53,12,5,41.7,7,58.3,16,8,8,6,2,5,12,41.7,7,6,1,5,5,21,5,0,4,10,28.6,"FW,MF"
"Anastasios Donis","2019-2020",44,33,21,63.6,12,36.4,3,2,2,1,0,1,9,11.1,8,2,0,2,1,4,3,0,8,24,25,"FW"
"Manu Koné","2019-2020",12,11,11,100,0,0,35,20,17,14,4,13,30,43.3,17,15,1,14,19,54,10,1,8,14,36.4,"MF"
"Robert Glatzel","2019-2020",127,28,19,67.9,9,32.1,19,14,8,6,5,5,23,21.7,18,11,2,9,2,21,16,0,106,198,34.9,"FW"
"William Saliba","2020-2021",3,11,10,90.9,1,9.1,15,9,8,5,2,5,6,83.3,1,17,16,1,26,41,80,2,36,22,62.1,"DF"
"Maxwel Cornet","2020-2021",196,39,23,59,16,41,70,41,39,24,7,33,58,56.9,25,23,5,18,43,113,47,2,41,34,54.7,"DF,FW"
"Nathan Collins","2020-2021",32,21,15,71.4,6,28.6,25,17,12,10,3,8,14,57.1,6,22,13,9,27,52,63,1,59,27,68.6,"DF"
"Connor Roberts","2020-2021",270,19,11,57.9,8,42.1,33,20,16,10,7,16,37,43.2,21,67,23,44,51,84,75,1,42,53,44.2,"DF,FW"
"Michael Olise","2020-2021",174,100,57,57,43,43,40,22,16,19,5,14,52,26.9,38,30,6,24,25,65,19,1,28,41,40.6,"MF,FW"
"Moise Kean","2020-2021",104,50,27,54,23,46,11,8,2,6,3,3,12,25,9,7,1,6,8,19,10,0,14,14,50,"FW"
"Boubakary Soumaré","2020-2021",38,34,29,85.3,5,14.7,44,29,16,25,3,14,29,48.3,15,14,6,8,39,83,21,0,30,18,62.5,"MF"
"Sheyi Ojo","2020-2021",105,73,34,46.6,39,53.4,36,27,13,16,7,8,23,34.8,15,18,1,17,8,44,10,1,24,47,33.8,"FW,MF"
"Sepp van den Berg","2020-2021",23,5,5,100,0,0,30,16,16,10,4,12,20,60,8,15,3,12,25,55,35,0,32,28,53.3,"DF"
"Pierre Lees-Melou","2020-2021",56,32,24,75,8,25,67,39,33,31,3,25,83,30.1,58,50,14,36,29,96,31,1,14,19,42.4,"MF"
"Jordan Hugill","2020-2021",41,5,1,20,4,80,1,1,0,1,0,0,3,0,3,6,3,3,3,4,12,0,35,39,47.3,"FW,MF"
"Sam McCallum","2020-2021",115,48,23,47.9,25,52.1,86,52,57,25,4,47,95,49.5,48,50,8,42,78,164,79,0,97,86,53,"DF"
"Onel Hernández","2020-2021",87,17,6,35.3,11,64.7,5,2,5,0,0,1,6,16.7,5,4,0,4,4,9,1,0,5,16,23.8,"FW,MF"
"Adam Armstrong","2020-2021",307,103,49,47.6,54,52.4,17,11,6,8,3,3,13,23.1,10,28,0,28,6,23,1,1,14,43,24.6,"FW"
"Romain Perraud","2020-2021",213,48,31,64.6,17,35.4,60,34,42,16,2,24,45,53.3,21,36,3,33,45,105,76,0,24,42,36.4,"DF"
"Ashley Fletcher","2020-2021",33,4,2,50,2,50,2,1,1,1,0,0,0,NA,0,2,0,2,2,4,7,0,22,41,34.9,"FW"
"Andre Gray","2020-2021",84,14,5,35.7,9,64.3,4,2,0,1,3,2,5,40,3,9,0,9,2,6,6,1,11,33,25,"FW"
"Domingos Quina","2020-2021",62,29,15,51.7,14,48.3,24,14,13,10,1,13,26,50,13,2,0,2,6,30,5,0,4,10,28.6,"MF"
"Philip Zinckernagel","2020-2021",52,29,14,48.3,15,51.7,20,9,8,10,2,10,43,23.3,33,10,1,9,4,24,11,0,5,17,22.7,"MF"
"Jean-Clair Todibo","2020-2021",2,23,17,73.9,6,26.1,25,15,16,9,0,16,31,51.6,15,13,7,6,19,44,48,1,26,22,54.2,"DF"
"Eduardo Camavinga","2020-2021",73,62,43,69.4,19,30.6,98,58,39,48,11,38,77,49.4,39,36,2,34,23,121,15,1,19,26,42.2,"MF"
"Ibrahim Amadou","2020-2021",14,15,10,66.7,5,33.3,39,26,18,19,2,15,38,39.5,23,14,4,10,23,62,25,0,19,17,52.8,"MF"
"Rony Lopes","2020-2021",159,61,30,49.2,31,50.8,20,14,4,13,3,6,27,22.2,21,14,3,11,8,28,6,0,9,17,34.6,"FW,MF"
"Boulaye Dia","2020-2021",163,83,46,55.4,37,44.6,23,12,3,11,9,4,22,18.2,18,19,5,14,12,35,37,1,31,92,25.2,"FW,MF"
"Youssouf Sabaly","2020-2021",129,71,41,57.7,30,42.3,47,33,24,17,6,27,45,60,18,31,8,23,49,96,57,2,25,25,50,"DF"
"Darío Benedetto","2020-2021",96,17,11,64.7,6,35.3,6,4,1,4,1,5,13,38.5,8,9,2,7,3,9,17,0,25,60,29.4,"FW"
"Yacine Adli","2020-2021",48,79,50,63.3,29,36.7,74,37,30,33,11,35,92,38,57,27,2,25,39,113,17,2,27,27,50,"MF"
"Fodé Ballo-Touré","2020-2021",52,9,3,33.3,6,66.7,21,17,9,11,1,6,13,46.2,7,7,0,7,6,27,11,1,12,10,54.5,"DF"
"Manuel De Luca","2020-2021",131,25,7,28,18,72,19,6,2,13,4,4,17,23.5,13,17,0,17,6,25,18,0,62,80,43.7,"FW"
"Abdoulaye Touré","2020-2021",23,30,21,70,9,30,28,12,10,16,2,14,31,45.2,17,17,2,15,22,50,19,0,33,22,60,"MF"
"Brandon Soppy","2020-2021",30,18,9,50,9,50,21,15,16,5,0,10,16,62.5,6,3,0,3,6,27,12,0,5,8,38.5,"DF"
"Raoul Bellanova","2020-2021",106,61,34,55.7,27,44.3,26,22,12,10,4,15,24,62.5,9,21,11,10,34,60,47,1,12,24,33.3,"DF"
"Michele Cavion","2020-2021",58,13,5,38.5,8,61.5,26,16,13,11,2,13,29,44.8,16,16,4,12,23,49,12,0,16,13,55.2,"MF"
"Joel Obi","2020-2021",21,29,19,65.5,10,34.5,77,45,33,38,6,16,41,39,25,28,6,22,49,126,32,1,72,67,51.8,"MF"
"Lassana Coulibaly","2020-2021",21,34,15,44.1,19,55.9,78,41,33,34,11,39,75,52,36,29,4,25,33,111,17,0,28,26,51.9,"MF"
"Omar Richards","2020-2021",187,91,55,60.4,36,39.6,114,72,70,37,7,46,74,62.2,28,44,7,37,56,170,65,1,23,36,39,"DF"
"Mohamed Simakan","2020-2021",21,13,10,76.9,3,23.1,32,22,21,6,5,9,18,50,9,17,11,6,31,63,41,0,27,25,51.9,"DF"
"Leonardo Balerdi","2020-2021",1,13,10,76.9,3,23.1,29,18,19,7,3,14,31,45.2,17,17,9,8,28,57,65,3,35,42,45.5,"DF"
"Mitchel Bakker","2020-2021",180,30,15,50,15,50,38,30,15,14,9,17,26,65.4,9,22,2,20,22,60,20,0,23,13,63.9,"DF"
"Myziane Maolida","2020-2021",92,44,21,47.7,23,52.3,13,8,4,4,5,4,11,36.4,7,6,1,5,6,19,4,0,3,19,13.6,"FW,MF"
"Niclas Eliasson","2020-2021",141,23,10,43.5,13,56.5,28,14,9,12,7,11,24,45.8,13,20,1,19,23,51,16,0,19,43,30.6,"MF,FW"
"Zinedine Ferhat","2020-2021",266,128,64,50,64,50,36,21,18,9,9,18,39,46.2,21,22,0,22,32,68,38,0,71,67,51.4,"FW,MF"
"Anthony Caci","2020-2021",86,42,27,64.3,15,35.7,80,46,47,27,6,35,69,50.7,34,30,4,26,55,135,65,1,27,42,39.1,"DF"
"Renato Sanches","2020-2021",51,58,40,69,18,31,13,7,4,8,1,5,25,20,20,13,2,11,13,26,8,0,8,20,28.6,"MF"
"Terem Moffi","2020-2021",131,58,24,41.4,34,58.6,13,8,0,8,5,4,19,21.1,15,5,2,3,4,17,8,0,38,78,32.8,"FW"
"Jonathan Gradit","2020-2021",11,48,34,70.8,14,29.2,60,39,26,28,6,22,38,57.9,16,37,19,18,56,116,81,1,55,54,50.5,"DF"
"Benoît Badiashile","2020-2021",6,7,4,57.1,3,42.9,24,17,15,9,0,13,28,46.4,15,21,12,9,58,82,102,4,108,40,73,"DF"
"Loïck Landre","2020-2021",1,5,4,80,1,20,14,7,9,5,0,13,28,46.4,15,22,19,3,31,45,52,0,26,34,43.3,"DF"
"Arber Zeneli","2020-2021",104,80,38,47.5,42,52.5,20,10,11,1,8,8,22,36.4,14,12,1,11,3,23,8,0,7,19,26.9,"MF,FW"
"Yvan Neyou","2020-2021",35,74,61,82.4,13,17.6,58,31,24,33,1,25,60,41.7,35,34,5,29,31,89,13,1,26,14,65,"MF"
"Denis Bouanga","2020-2021",222,127,57,44.9,70,55.1,52,28,22,24,6,16,58,27.6,42,32,3,29,20,72,36,0,65,91,41.7,"MF,FW"
"Romain Hamouma","2020-2021",165,84,36,42.9,48,57.1,12,7,5,6,1,4,24,16.7,20,17,1,16,7,19,11,0,18,47,27.7,"FW,MF"
"Yvann Macon","2020-2021",17,12,8,66.7,4,33.3,30,20,20,8,2,7,19,36.8,12,6,2,4,9,39,13,0,10,11,47.6,"DF"
"Romain Del Castillo","2020-2021",104,33,19,57.6,14,42.4,30,11,5,14,11,5,25,20,20,6,0,6,3,33,4,1,11,12,47.8,"MF,FW"
"Rafinha","2020-2021",63,43,29,67.4,14,32.6,54,26,18,28,8,28,49,57.1,21,18,3,15,13,67,6,0,7,11,38.9,"MF,FW"
"Jean-Kevin Duverne","2020-2021",10,19,18,94.7,1,5.3,38,21,24,14,0,15,32,46.9,17,24,16,8,30,68,70,0,38,50,43.2,"DF"
"Jordan Marié","2020-2021",24,18,11,61.1,7,38.9,34,17,9,23,2,23,56,41.1,33,14,5,9,23,57,12,2,12,9,57.1,"MF"
"Kévin Denkey","2020-2021",37,9,5,55.6,4,44.4,4,2,0,3,1,0,3,0,3,2,0,2,1,5,2,0,8,16,33.3,"FW"
"Elye Wahi","2020-2021",44,19,7,36.8,12,63.2,4,3,2,1,1,1,6,16.7,5,4,0,4,2,6,5,0,10,13,43.5,"FW"
"Sébastien Corchia","2020-2021",97,37,17,45.9,20,54.1,55,30,29,17,9,33,60,55,27,28,10,18,38,93,40,1,24,29,45.3,"DF"
"Ibrahima Sissoko","2020-2021",51,41,29,70.7,12,29.3,68,48,25,35,8,28,68,41.2,40,22,5,17,48,116,44,0,55,23,70.5,"MF"
"Hianga Mananga Mbock","2020-2021",4,10,9,90,1,10,4,3,2,2,0,2,9,22.2,7,2,0,2,3,7,6,0,9,6,60,"MF,FW"
"Ryad Boudebouz","2020-2021",36,24,14,58.3,10,41.7,9,4,1,7,1,4,8,50,4,3,0,3,5,14,5,0,4,13,23.5,"MF,FW"
"Jean Seri","2020-2021",5,22,16,72.7,6,27.3,17,9,3,12,2,4,15,26.7,11,8,2,6,12,29,7,0,7,10,41.2,"MF"
"Jean-Ricner Bellegarde","2020-2021",97,78,45,57.7,33,42.3,56,39,22,25,9,14,23,60.9,9,20,2,18,19,75,16,0,23,44,34.3,"MF,FW"
"Loïc Bade","2020-2021",2,26,23,88.5,3,11.5,57,34,47,10,0,30,55,54.5,25,43,17,26,74,131,135,2,112,62,64.4,"DF"
"Ibrahima Diallo","2020-2021",3,12,9,75,3,25,14,9,2,9,3,4,8,50,4,4,0,4,3,17,3,0,1,3,25,"MF"
"Nelson Sissoko","2020-2021",14,5,3,60,2,40,12,6,6,3,3,7,12,58.3,5,2,1,1,12,24,16,1,8,11,42.1,"DF"
"Marco Verratti","2020-2021",67,60,48,80,12,20,53,30,17,25,11,24,72,33.3,48,22,5,17,26,79,4,1,11,12,47.8,"MF"
"Houboulang Mendes","2020-2021",76,28,10,35.7,18,64.3,28,19,19,5,4,16,28,57.1,12,14,2,12,14,42,35,0,13,21,38.2,"DF"
"Anthony Briançon","2020-2021",0,1,1,100,0,0,12,7,9,3,0,9,19,47.4,10,19,12,7,33,45,57,2,24,21,53.3,"DF"
"Burak Yılmaz","2020-2021",147,29,15,51.7,14,48.3,13,6,3,7,3,4,30,13.3,26,7,0,7,5,18,22,0,37,60,38.1,"FW"
"Brendan Chardonnet","2020-2021",7,5,5,100,0,0,51,29,31,19,1,27,41,65.9,14,54,41,13,64,115,151,0,76,49,60.8,"DF"
"Mehdi Chahiri","2020-2021",77,44,28,63.6,16,36.4,18,8,7,5,6,8,20,40,12,9,0,9,6,24,5,0,11,12,47.8,"FW,MF"
"Gaëtan Charbonnier","2020-2021",123,50,32,64,18,36,24,15,6,11,7,12,32,37.5,20,15,1,14,9,33,19,0,30,46,39.5,"MF,FW"
"Sofiane Diop","2020-2021",132,71,45,63.4,26,36.6,49,34,17,25,7,18,53,34,35,25,1,24,31,80,15,0,18,32,36,"MF,FW"
"Hassane Kamara","2020-2021",214,61,36,59,25,41,65,39,40,16,9,27,49,55.1,22,39,12,27,55,120,61,1,36,38,48.6,"DF,FW"
"Steve Mounié","2020-2021",140,27,13,48.1,14,51.9,15,11,3,11,1,3,28,10.7,25,18,3,15,12,27,40,0,257,105,71,"FW"
"Ángel Di María","2020-2021",219,78,40,51.3,38,48.7,26,17,6,8,12,11,45,24.4,34,14,1,13,6,32,7,0,0,1,0,"FW,MF"
"Julian Draxler","2020-2021",94,25,15,60,10,40,13,6,5,6,2,5,20,25,15,4,0,4,14,27,0,0,4,3,57.1,"MF,FW"
"Pablo Martinez","2020-2021",0,1,0,0,1,100,10,7,7,3,0,7,7,100,0,6,4,2,11,21,28,0,10,8,55.6,"DF"
"Dereck Kutesa","2020-2021",68,31,14,45.2,17,54.8,15,7,7,3,5,5,14,35.7,9,7,1,6,7,22,3,0,9,13,40.9,"MF,FW"
"Melvin Bard","2020-2021",48,11,8,72.7,3,27.3,12,8,7,4,1,6,11,54.5,5,10,2,8,6,18,14,0,11,14,44,"DF"
"Damien Da Silva","2020-2021",4,11,10,90.9,1,9.1,22,13,13,8,1,12,18,66.7,6,17,13,4,44,66,99,1,75,38,66.4,"DF"
"M'Baye Niang","2020-2021",30,7,1,14.3,6,85.7,3,2,2,1,0,0,0,NA,0,2,0,2,1,4,2,0,13,16,44.8,"FW"
"Benjamin Bourigeaud","2020-2021",164,16,8,50,8,50,40,23,17,16,7,21,71,29.6,50,37,1,36,19,59,25,0,18,45,28.6,"MF,FW"
"Lamine Fomba","2020-2021",23,30,14,46.7,16,53.3,66,36,30,25,11,30,65,46.2,35,48,19,29,59,125,39,2,30,29,50.8,"MF"
"Jordan Amavi","2020-2021",33,20,12,60,8,40,11,9,9,1,1,9,12,75,3,12,2,10,27,38,33,1,23,11,67.6,"DF"
"Vincent Le Goff","2020-2021",83,21,13,61.9,8,38.1,42,29,16,24,2,18,49,36.7,31,27,5,22,44,86,44,0,20,38,34.5,"DF"
"Ignatius Ganago","2020-2021",107,43,23,53.5,20,46.5,4,3,0,2,2,3,12,25,9,7,1,6,6,10,3,0,21,30,41.2,"FW"
"Otávio","2020-2021",6,8,5,62.5,3,37.5,54,31,33,19,2,26,55,47.3,29,20,5,15,26,80,36,0,9,12,42.9,"MF"
"Junior Sambia","2020-2021",122,74,37,50,37,50,41,29,20,14,7,26,38,68.4,12,27,14,13,39,80,46,0,41,35,53.9,"DF,MF"
"Yoane Wissa","2020-2021",184,98,55,56.1,43,43.9,35,20,12,14,9,11,34,32.4,23,25,3,22,20,55,14,0,47,31,60.3,"MF,FW"
"Paul Baysse","2020-2021",6,2,2,100,0,0,35,18,21,13,1,16,21,76.2,5,33,24,9,52,87,123,1,67,51,56.8,"DF"
"Aimen Moueffek","2020-2021",12,33,20,60.6,13,39.4,25,15,16,6,3,13,32,40.6,19,17,2,15,9,34,18,0,16,8,66.7,"DF,MF"
"Wahbi Khazri","2020-2021",64,59,26,44.1,33,55.9,24,15,12,7,5,12,24,50,12,10,1,9,4,28,11,0,4,23,14.8,"FW"
"Romain Thomas","2020-2021",5,3,2,66.7,1,33.3,47,25,34,11,2,20,35,57.1,15,35,20,15,50,97,138,0,97,53,64.7,"DF"
"Xavier Chavalerin","2020-2021",44,27,18,66.7,9,33.3,92,50,47,38,7,26,74,35.1,48,43,9,34,43,135,29,1,15,16,48.4,"MF"
"Nayef Aguerd","2020-2021",2,11,9,81.8,2,18.2,37,30,28,9,0,21,33,63.6,12,34,22,12,47,84,102,0,121,71,63,"DF"
"Thierry Ambrose","2020-2021",77,31,18,58.1,13,41.9,7,4,1,1,5,2,12,16.7,10,2,0,2,2,9,4,0,21,29,42,"FW"
"Tom Lacoux","2020-2021",8,7,5,71.4,2,28.6,22,14,10,11,1,9,21,42.9,12,12,3,9,12,34,7,0,3,4,42.9,"MF"
"Colin Dagba","2020-2021",110,11,7,63.6,4,36.4,23,11,4,17,2,14,19,73.7,5,18,5,13,16,39,18,1,2,11,15.4,"DF"
"Aaron Leya Iseka","2020-2021",51,19,11,57.9,8,42.1,6,4,2,3,1,0,4,0,4,4,2,2,0,6,6,0,29,41,41.4,"FW"
"Mathieu Cafaro","2020-2021",111,52,21,40.4,31,59.6,40,17,15,19,6,13,43,30.2,30,11,0,11,17,57,12,0,8,17,32,"MF,FW"
"Marshall Munetsi","2020-2021",14,22,15,68.2,7,31.8,35,19,19,14,2,21,41,51.2,20,33,25,8,57,92,85,3,54,32,62.8,"MF,DF"
"Haris Belkebla","2020-2021",32,34,23,67.6,11,32.4,69,39,32,28,9,31,66,47,35,26,5,21,57,126,34,0,23,34,40.4,"MF"
"Florian Thauvin","2020-2021",281,109,58,53.2,51,46.8,40,22,14,21,5,20,54,37,34,26,2,24,14,54,11,0,12,12,50,"FW,MF"
"Armand Lauriente","2020-2021",144,97,55,56.7,42,43.3,30,10,10,19,1,7,26,26.9,19,21,0,21,15,45,4,0,13,16,44.8,"MF,FW"
"Marcus Coco","2020-2021",97,41,23,56.1,18,43.9,36,21,17,15,4,16,36,44.4,20,16,3,13,20,56,17,0,37,44,45.7,"MF,FW"
"Stephy Mavididi","2020-2021",140,82,35,42.7,47,57.3,18,5,7,10,1,8,23,34.8,15,12,0,12,14,32,6,0,12,43,21.8,"FW,MF"
"Bersant Celina","2020-2021",120,50,29,58,21,42,20,12,8,8,4,7,38,18.4,31,20,2,18,8,28,10,0,3,22,12,"MF,FW"
"Nolan Roux","2020-2021",36,4,2,50,2,50,7,3,1,4,2,3,8,37.5,5,6,0,6,5,12,4,0,11,26,29.7,"FW"
"Caio Henrique Oliveira Silva","2020-2021",185,27,17,63,10,37,50,34,25,20,5,31,51,60.8,20,20,3,17,16,66,37,0,19,28,40.4,"DF"
"Laurent Abergel","2020-2021",35,37,29,78.4,8,21.6,145,84,64,69,12,54,162,33.3,108,64,6,58,46,191,12,0,9,17,34.6,"MF"
"Zeki Çelik","2020-2021",119,40,21,52.5,19,47.5,72,33,30,30,12,44,81,54.3,37,32,6,26,38,110,52,0,25,22,53.2,"DF"
"Yunis Abdelhamid","2020-2021",3,16,7,43.8,9,56.3,59,37,36,23,0,26,42,61.9,16,34,15,19,61,120,132,0,92,53,63.4,"DF"
"Abdoul Kader Bamba","2020-2021",96,47,27,57.4,20,42.6,18,3,7,8,3,11,18,61.1,7,10,0,10,7,25,4,1,4,10,28.6,"FW,MF"
"Cesc Fàbregas","2020-2021",48,11,6,54.5,5,45.5,20,12,6,9,5,9,22,40.9,13,11,1,10,13,33,3,0,7,7,50,"MF,FW"
"Raphinha","2020-2021",31,25,10,40,14,56,5,2,1,3,1,1,4,25,3,5,0,5,3,8,4,0,5,7,41.7,"FW,MF"
"Christophe Hérelle","2020-2021",3,5,4,80,1,20,19,13,12,6,1,10,12,83.3,2,13,9,4,31,50,41,2,36,20,64.3,"DF"
"Aleksandr Golovin","2020-2021",93,33,18,54.5,15,45.5,28,16,6,18,4,8,39,20.5,31,21,0,21,11,39,3,0,11,16,40.7,"MF,FW"
"Jordan Ferri","2020-2021",41,28,16,57.1,12,42.9,58,40,34,22,2,31,103,30.1,72,30,5,25,8,66,18,1,20,24,45.5,"MF"
"Andrei Girotto","2020-2021",6,5,3,60,2,40,65,41,50,15,0,39,70,55.7,31,34,15,19,59,124,103,0,85,52,62,"DF,MF"
"Fabien Centonze","2020-2021",191,119,59,49.6,60,50.4,104,68,64,30,10,43,73,58.9,30,62,17,45,112,216,119,1,56,33,62.9,"DF"
"Lucas Gourna-Douath","2020-2021",6,13,8,61.5,5,38.5,32,22,18,11,3,15,28,53.6,13,10,0,10,24,56,18,0,14,12,53.8,"MF"
"Ruben Aguilar","2020-2021",231,29,12,41.4,17,58.6,63,37,32,21,10,32,52,61.5,20,30,3,27,47,110,43,1,46,38,54.8,"DF,MF"
"Gelson Martins","2020-2021",191,79,40,50.6,39,49.4,41,26,12,16,13,15,37,40.5,22,20,0,20,13,54,8,0,9,25,26.5,"MF,FW"
"Moussa Koné","2020-2021",85,48,27,56.3,21,43.8,13,6,1,8,4,2,9,22.2,7,7,1,6,2,15,7,0,16,73,18,"FW"
"Daniel Congré","2020-2021",4,6,4,66.7,2,33.3,59,35,45,12,2,36,70,51.4,34,50,33,17,69,128,144,3,71,41,63.4,"DF"
"Aboubakar Kamara","2020-2021",37,15,8,53.3,7,46.7,3,1,0,2,1,1,7,14.3,6,1,0,1,0,3,2,0,15,21,41.7,"FW,MF"
"Layvin Kurzawa","2020-2021",121,22,14,63.6,8,36.4,26,19,10,10,6,9,28,32.1,19,20,5,15,28,54,26,1,30,13,69.8,"DF"
"Álvaro González","2020-2021",4,3,3,100,0,0,26,17,20,6,0,19,31,61.3,12,30,18,12,33,59,119,1,46,38,54.8,"DF"
"Jonathan Ikone","2020-2021",117,87,53,60.9,34,39.1,18,12,3,8,7,9,22,40.9,13,16,1,15,7,25,9,0,17,40,29.8,"MF,FW"
"Kylian Mbappé","2020-2021",345,181,90,49.7,91,50.3,4,2,0,1,3,2,9,22.2,7,7,1,6,3,7,4,1,5,14,26.3,"FW"
"Ander Herrera","2020-2021",57,23,12,52.2,11,47.8,53,35,17,26,10,30,77,39,47,31,5,26,31,84,22,1,8,12,40,"MF"
"Mauro Icardi","2020-2021",46,5,3,60,2,40,6,2,1,2,3,4,13,30.8,9,3,1,2,3,9,7,0,15,11,57.7,"FW"
"Alexander Djiku","2020-2021",7,6,5,83.3,1,16.7,60,41,45,13,2,32,52,61.5,20,28,10,18,91,151,104,0,53,36,59.6,"DF,MF"
"Lucas Deaux","2020-2021",47,30,19,63.3,11,36.7,47,32,20,22,5,16,49,32.7,33,20,3,17,20,67,30,4,36,28,56.3,"MF,DF"
"Mounir Chouiar","2020-2021",83,81,46,56.8,35,43.2,22,12,10,9,3,6,18,33.3,12,10,0,10,11,33,8,0,13,16,44.8,"FW,MF"
"Ludovic Ajorque","2020-2021",224,23,10,43.5,13,56.5,30,18,6,18,6,7,31,22.6,24,14,5,9,11,41,54,0,166,133,55.5,"FW"
"Jimmy Cabot","2020-2021",84,56,24,42.9,32,57.1,26,13,8,14,4,11,36,30.6,25,8,0,8,12,38,6,0,1,7,12.5,"FW,MF"
"Nathanael Mbuku","2020-2021",114,68,43,63.2,25,36.8,33,19,9,13,11,8,28,28.6,20,17,0,17,14,47,10,0,26,43,37.7,"MF,FW"
"Jonas Martin","2020-2021",9,7,2,28.6,5,71.4,11,9,5,4,2,5,14,35.7,9,11,2,9,13,24,2,1,6,6,50,"MF"
"Abdul Majeed Waris","2020-2021",43,13,6,46.2,7,53.8,1,1,1,0,0,1,6,16.7,5,0,0,0,2,3,2,0,3,7,30,"FW,MF"
"Charles Abi","2020-2021",48,24,12,50,12,50,8,2,5,0,3,3,12,25,9,6,2,4,4,12,5,0,37,59,38.5,"FW,MF"
"Ibrahima Niane","2020-2021",44,13,6,46.2,7,53.8,1,1,0,0,1,1,2,50,1,3,0,3,0,1,8,0,23,30,43.4,"FW"
"Gaëtan Paquiez","2020-2021",18,12,5,41.7,7,58.3,21,12,12,7,2,12,29,41.4,17,10,3,7,16,37,28,0,19,13,59.4,"DF"
"Jason Denayer","2020-2021",3,6,6,100,0,0,25,16,16,9,0,6,13,46.2,7,36,25,11,27,52,91,1,46,39,54.1,"DF"
"El Bilal Touré","2020-2021",65,22,10,45.5,12,54.5,22,12,3,16,3,8,18,44.4,10,8,3,5,6,28,10,1,69,90,43.4,"FW"
"Jean-Eudes Aholou","2020-2021",25,33,26,78.8,7,21.2,47,25,18,26,3,20,51,39.2,31,17,5,12,54,101,33,0,41,30,57.7,"MF"
"Andrew Gravillon","2020-2021",10,8,7,87.5,1,12.5,26,17,17,9,0,13,28,46.4,15,44,31,13,59,85,118,4,53,51,51,"DF"
"Kévin Monnet-Paquet","2020-2021",46,18,6,33.3,12,66.7,11,7,7,2,2,5,10,50,5,5,0,5,6,17,7,0,4,19,17.4,"MF,FW"
"Adrian Grbić","2020-2021",53,11,2,18.2,9,81.8,6,4,2,2,2,1,7,14.3,6,6,0,6,5,11,7,0,28,41,40.6,"FW"
"Yuto Nagatomo","2020-2021",64,23,10,43.5,13,56.5,23,16,12,8,3,9,18,50,9,14,3,11,29,52,43,0,16,16,50,"DF"
"Angelo Fulgini","2020-2021",192,155,81,52.3,74,47.7,22,13,4,12,6,12,34,35.3,22,17,0,17,15,37,9,0,20,44,31.3,"MF"
"Lois Diony","2020-2021",159,48,13,27.1,35,72.9,15,10,3,9,3,4,18,22.2,14,6,3,3,5,20,16,0,46,77,37.4,"FW"
"Enock Kwateng","2020-2021",35,12,8,66.7,4,33.3,21,12,15,4,2,14,27,51.9,13,15,3,12,26,47,27,0,23,14,62.2,"DF"
"Mamadou Fofana","2020-2021",2,2,2,100,0,0,25,11,17,8,0,7,31,22.6,24,14,2,12,18,43,36,0,11,13,45.8,"MF,DF"
"Djibril Sidibé","2020-2021",37,15,8,53.3,7,46.7,58,34,26,29,3,37,52,71.2,15,20,5,15,50,108,37,2,25,20,55.6,"DF"
"Arnaud Souquet","2020-2021",61,20,11,55,9,45,50,33,35,13,2,27,48,56.3,21,15,6,9,17,67,34,0,7,22,24.1,"DF"
"Aurélien Tchouaméni","2020-2021",52,35,22,62.9,13,37.1,127,68,47,62,18,48,92,52.2,44,39,11,28,60,187,47,0,81,41,66.4,"MF"
"Stéphane Bahoken","2020-2021",110,24,14,58.3,10,41.7,9,6,1,7,1,4,12,33.3,8,9,0,9,9,18,9,0,26,55,32.1,"FW"
"Martin Terrier","2020-2021",188,43,26,60.5,17,39.5,33,15,5,15,13,10,36,27.8,26,23,0,23,16,49,7,0,49,65,43,"FW,MF"
"Massadio Haïdara","2020-2021",90,31,15,48.4,16,51.6,48,32,21,21,6,23,37,62.2,14,29,6,23,35,83,60,0,42,27,60.9,"DF"
"Morgan Schneiderlin","2020-2021",21,18,14,77.8,4,22.2,51,31,21,24,6,20,54,37,34,21,11,10,53,104,46,0,39,25,60.9,"MF"
"Thilo Kehrer","2020-2021",21,5,3,60,2,40,31,26,17,11,3,10,26,38.5,16,16,4,12,15,46,37,1,30,19,61.2,"DF"
"Jonathan Clauss","2020-2021",235,49,22,44.9,27,55.1,43,20,12,20,11,17,38,44.7,21,24,1,23,45,88,46,0,18,26,40.9,"DF"
"Seko Fofana","2020-2021",126,74,41,55.4,33,44.6,16,8,3,10,3,4,26,15.4,22,16,5,11,34,50,23,1,22,10,68.8,"MF"
"Sofiane Alakouch","2020-2021",47,36,18,50,18,50,53,33,30,16,7,29,45,64.4,16,17,2,15,21,74,38,0,7,13,35,"DF"
"Naomichi Ueda","2020-2021",0,1,1,100,0,0,4,2,3,1,0,4,6,66.7,2,5,4,1,6,10,30,1,13,9,59.1,"DF"
"Mehdi Zerkane","2020-2021",48,37,16,43.2,21,56.8,23,15,7,10,6,5,18,27.8,13,15,2,13,9,32,5,0,18,18,50,"MF,FW"
"Paul Lasne","2020-2021",10,5,5,100,0,0,46,26,25,19,2,17,40,42.5,23,25,5,20,47,93,17,2,22,20,52.4,"MF"
"Fabien Lemoine","2020-2021",26,16,10,62.5,6,37.5,74,45,39,33,2,36,89,40.4,53,25,1,24,27,101,35,0,29,26,52.7,"MF"
"Trevoh Chalobah","2020-2021",20,52,38,73.1,14,26.9,45,26,32,13,0,24,50,48,26,20,7,13,69,114,56,0,43,34,55.8,"DF,MF"
"Boubakar Kouyaté","2020-2021",3,3,2,66.7,1,33.3,60,35,45,15,0,32,58,55.2,26,44,27,17,60,120,132,1,99,40,71.2,"DF"
"Mickaël Cuisance","2020-2021",53,33,13,39.4,20,60.6,24,11,2,15,7,10,33,30.3,23,13,1,12,3,27,4,0,10,19,34.5,"MF"
"Steven Fortes","2020-2021",0,7,3,42.9,4,57.1,33,20,20,10,3,16,22,72.7,6,25,10,15,27,60,52,0,36,22,62.1,"DF"
"Dimitri Payet","2020-2021",248,61,37,60.7,24,39.3,27,17,4,16,7,17,40,42.5,23,19,2,17,8,35,10,0,4,14,22.2,"FW,MF"
"Lilian Brassier","2020-2021",15,6,4,66.7,2,33.3,19,10,12,4,3,7,11,63.6,4,13,6,7,23,42,38,1,33,11,75,"DF"
"Gaël Kakuta","2020-2021",123,102,52,51,50,49,38,23,10,18,10,8,44,18.2,36,24,3,21,17,55,4,0,21,51,29.2,"MF,FW"
"Lionel Carole","2020-2021",38,13,5,38.5,8,61.5,37,25,18,14,5,16,29,55.2,13,3,1,2,38,75,28,0,25,10,71.4,"DF"
"Karl Toko Ekambi","2020-2021",281,106,61,57.5,45,42.5,16,10,5,3,8,8,32,25,24,20,1,19,26,42,8,0,35,44,44.3,"FW"
"Adrien Truffert","2020-2021",157,35,18,51.4,17,48.6,38,18,18,12,8,13,24,54.2,11,26,5,21,18,56,38,1,18,24,42.9,"DF,MF"
"Roger Assalé","2020-2021",58,23,10,43.5,13,56.5,10,8,3,5,2,4,12,33.3,8,7,3,4,2,12,2,0,5,16,23.8,"FW,MF"
"Frederic Guilbert","2020-2021",48,30,16,53.3,14,46.7,37,19,23,11,3,21,34,61.8,13,14,1,13,33,70,32,0,16,18,47.1,"DF"
"Irvin Cardona","2020-2021",164,26,10,38.5,16,61.5,10,5,3,6,1,4,22,18.2,18,17,3,14,9,19,23,2,23,28,45.1,"FW"
"Matteo Ahlinvi","2020-2021",17,29,19,65.5,10,34.5,26,20,10,14,2,11,39,28.2,28,6,0,6,2,28,8,0,8,13,38.1,"MF"
"Harold Moukoudi","2020-2021",5,15,11,73.3,4,26.7,46,27,37,8,1,28,38,73.7,10,24,10,14,42,88,78,1,52,31,62.7,"DF"
"Moses Simon","2020-2021",223,95,47,49.5,48,50.5,27,14,11,9,7,17,36,47.2,19,24,1,23,15,42,15,1,19,32,37.3,"FW,MF"
"Thibault De Smet","2020-2021",30,4,2,50,2,50,11,6,8,3,0,6,15,40,9,8,1,7,6,17,16,0,8,10,44.4,"DF"
"Gerzino Nyamsi","2020-2021",1,6,5,83.3,1,16.7,12,10,2,8,2,4,6,66.7,2,8,5,3,10,22,32,1,21,15,58.3,"DF"
"Stanley N'Soki","2020-2021",14,7,5,71.4,2,28.6,27,19,15,9,3,13,22,59.1,9,17,4,13,26,53,38,2,28,9,75.7,"DF"
"Ludovic Blas","2020-2021",148,154,94,61,60,39,58,30,18,37,3,23,54,42.6,31,33,4,29,21,79,19,0,15,46,24.6,"MF,FW"
"Ismaël Boura","2020-2021",56,17,11,64.7,6,35.3,11,7,8,2,1,3,9,33.3,6,7,2,5,21,32,12,0,12,10,54.5,"DF"
"Moussa Doumbia","2020-2021",102,50,23,46,27,54,10,6,4,4,2,4,22,18.2,18,5,1,4,10,20,4,0,3,17,15,"MF,FW"
"Ronaël Pierre-Gabriel","2020-2021",78,57,35,61.4,22,38.6,60,40,42,16,2,35,52,67.3,17,17,7,10,30,90,57,0,21,26,44.7,"DF"
"Kevin Volland","2020-2021",237,42,17,40.5,25,59.5,33,16,11,19,3,8,34,23.5,26,23,0,23,4,37,4,0,56,66,45.9,"FW,MF"
"Habib Diallo","2020-2021",170,32,16,50,16,50,12,7,3,7,2,8,19,42.1,11,12,2,10,13,25,17,0,103,115,47.2,"FW"
"Pedro Mendes","2020-2021",1,3,3,100,0,0,21,19,16,5,0,14,21,66.7,7,23,13,10,34,55,58,0,28,31,47.5,"DF"
"Yannick Cahuzac","2020-2021",50,7,4,57.1,3,42.9,26,12,12,10,4,9,27,33.3,18,18,5,13,33,59,72,0,30,26,53.6,"MF"
"Senou Coulibaly","2020-2021",1,10,7,70,3,30,33,21,23,10,0,12,24,50,12,18,12,6,30,63,89,0,43,42,50.6,"DF"
"Pedro Chirivella","2020-2021",34,11,6,54.5,5,45.5,26,8,7,13,6,14,49,28.6,35,23,4,19,41,67,19,0,9,23,28.1,"MF"
"Neymar","2020-2021",163,155,87,56.1,68,43.9,14,11,1,6,7,8,37,21.6,29,8,0,8,9,23,0,0,5,12,29.4,"MF,FW"
"Youcef Atal","2020-2021",95,36,20,55.6,16,44.4,25,12,11,14,0,13,26,50,13,10,2,8,26,51,12,0,8,20,28.6,"DF,FW"
"Ghislain Konan","2020-2021",127,73,43,58.9,30,41.1,57,32,35,17,5,32,56,57.1,24,25,11,14,30,87,67,0,25,27,48.1,"DF"
"Téji Savanier","2020-2021",76,82,51,62.2,31,37.8,49,33,16,25,8,22,73,30.1,51,28,6,22,38,87,15,0,18,21,46.2,"MF"
"Sacha Boey","2020-2021",98,45,22,48.9,23,51.1,57,43,32,24,1,30,59,50.8,29,25,5,20,43,100,64,0,25,26,49,"DF"
"Sinaly Diomande","2020-2021",9,8,6,75,2,25,10,7,8,1,1,5,14,35.7,9,19,15,4,33,43,53,1,49,15,76.6,"DF"
"Wesley Lautoa","2020-2021",5,6,3,50,3,50,36,20,20,13,3,11,37,29.7,26,17,8,9,29,65,33,1,22,13,62.9,"MF,DF"
"Morgan Sanson","2020-2021",46,19,9,47.4,10,52.6,21,12,6,12,3,9,28,32.1,19,12,0,12,9,30,5,0,6,14,30,"MF"
"Facundo Medina","2020-2021",6,11,7,63.6,4,36.4,39,22,22,15,2,24,38,63.2,14,25,9,16,39,78,51,3,25,29,46.3,"DF"
"Enzo Le Fée","2020-2021",76,62,41,66.1,21,33.9,51,28,23,23,5,27,73,37,46,30,6,24,25,76,10,0,4,21,16,"MF"
"Yassine Benzia","2020-2021",11,12,8,66.7,4,33.3,10,5,5,3,2,2,10,20,8,3,0,3,6,16,2,0,4,7,36.4,"MF,FW"
"Birger Meling","2020-2021",98,24,16,66.7,8,33.3,49,31,27,15,7,33,50,66,17,43,9,34,36,85,70,0,21,17,55.3,"DF"
"Pape Gueye","2020-2021",29,12,7,58.3,5,41.7,49,21,25,19,5,15,45,33.3,30,25,6,19,47,96,34,0,46,39,54.1,"MF"
"Bruno Ecuele Manga","2020-2021",2,13,11,84.6,2,15.4,52,38,46,6,0,29,40,72.5,11,50,33,17,57,109,165,3,125,65,65.8,"DF"
"Idrissa Gana Gueye","2020-2021",30,36,24,66.7,12,33.3,63,35,20,34,9,26,50,52,24,26,7,19,20,83,9,3,25,19,56.8,"MF"
"Alexis Claude-Maurice","2020-2021",116,73,48,65.8,25,34.2,40,19,17,14,9,14,48,29.2,34,16,2,14,14,54,3,0,8,19,29.6,"MF,FW"
"Vagner Gonçalves","2020-2021",73,20,9,45,11,55,16,9,5,5,6,2,15,13.3,13,6,0,6,4,20,1,1,8,39,17,"FW,MF"
"Romain Faivre","2020-2021",166,132,89,67.4,43,32.6,54,27,26,23,5,21,54,38.9,33,30,0,30,30,84,18,0,15,27,35.7,"MF,FW"
"Hatem Ben Arfa","2020-2021",131,120,76,63.3,44,36.7,11,7,1,7,3,2,9,22.2,7,3,0,3,2,13,0,0,4,9,30.8,"MF,FW"
"Opa Nguette","2020-2021",85,57,28,49.1,29,50.9,15,8,2,8,5,3,10,30,7,14,2,12,1,16,1,0,36,49,42.4,"FW,MF"
"Julien Faussurier","2020-2021",63,9,5,55.6,4,44.4,16,11,6,8,2,11,25,44,14,12,4,8,9,25,10,0,8,8,50,"DF"
"Kenny Lala","2020-2021",88,34,16,47.1,18,52.9,22,13,13,8,1,11,22,50,11,12,6,6,23,45,33,1,19,15,55.9,"DF"
"Kévin Zohi","2020-2021",45,25,15,60,10,40,9,5,3,4,2,2,6,33.3,4,6,0,6,6,15,3,0,7,4,63.6,"FW,MF"
"Nicolas Pallois","2020-2021",5,26,17,65.4,9,34.6,58,36,42,14,2,38,72,52.8,34,44,20,24,37,95,155,1,60,40,60,"DF"
"Joris Chotard","2020-2021",21,12,10,83.3,2,16.7,12,8,5,6,1,6,31,19.4,25,12,3,9,11,23,15,0,10,9,52.6,"MF"
"Jonathan Delaplace","2020-2021",48,7,4,57.1,3,42.9,8,5,5,1,2,7,13,53.8,6,12,5,7,17,25,19,1,4,8,33.3,"DF"
"Saîf-Eddine Khaoui","2020-2021",39,16,9,56.3,7,43.8,19,11,7,6,6,7,16,43.8,9,8,0,8,12,31,1,0,1,12,7.7,"FW,DF"
"Pierrick Capelle","2020-2021",90,39,22,56.4,17,43.6,53,28,24,17,12,31,79,39.2,48,25,1,24,47,100,32,0,42,51,45.2,"MF,DF"
"Florian Sotoca","2020-2021",231,36,19,52.8,17,47.2,31,20,3,20,8,6,22,27.3,16,27,0,27,9,40,24,0,89,112,44.3,"FW"
"Arnaud Nordin","2020-2021",101,58,29,50,29,50,14,8,5,5,4,6,21,28.6,15,13,2,11,9,23,10,0,7,24,22.6,"MF,FW"
"Gaëtan Laborde","2020-2021",237,70,33,47.1,37,52.9,43,22,21,17,5,16,60,26.7,44,29,3,26,16,59,25,1,134,127,51.3,"FW,MF"
"Tino Kadewere","2020-2021",186,55,29,52.7,26,47.3,35,22,12,16,7,17,49,34.7,32,16,3,13,21,56,31,0,33,38,46.5,"FW"
"Antonin Bobichon","2020-2021",58,26,18,69.2,8,30.8,23,14,10,8,5,9,15,60,6,4,1,3,2,25,1,0,8,12,40,"MF,FW"
"Khéphren Thuram","2020-2021",17,28,22,78.6,6,21.4,32,16,5,21,6,9,27,33.3,18,21,9,12,18,50,22,1,18,23,43.9,"MF"
"Corentin Jean","2020-2021",55,17,8,47.1,9,52.9,4,3,1,1,2,0,5,0,5,4,0,4,2,6,2,0,5,17,22.7,"FW,MF"
"Florent Mollet","2020-2021",127,36,14,38.9,22,61.1,20,15,7,11,2,12,47,25.5,35,18,4,14,32,52,9,1,11,29,27.5,"MF"
"Flavius Daniliuc","2020-2021",7,3,3,100,0,0,23,15,15,5,3,10,21,47.6,11,17,6,11,14,37,32,0,16,25,39,"DF"
"Abdoulaye Bamba","2020-2021",60,9,4,44.4,5,55.6,27,17,19,7,1,19,28,67.9,9,7,1,6,19,46,34,0,10,9,52.6,"DF"
"Toma Bašić","2020-2021",76,31,23,74.2,8,25.8,33,22,15,16,2,16,58,27.6,42,21,5,16,32,65,42,1,25,30,45.5,"MF"
"Youssouf Fofana","2020-2021",36,61,32,52.5,29,47.5,90,51,31,51,8,42,82,51.2,40,43,7,36,34,124,14,2,19,17,52.8,"MF"
"Bruno Guimarães","2020-2021",56,32,25,78.1,7,21.9,76,34,26,41,9,30,64,46.9,34,24,4,20,14,90,13,0,9,7,56.3,"MF"
"Thomas Delaine","2020-2021",113,51,29,56.9,22,43.1,32,18,19,11,2,20,35,57.1,15,22,5,17,24,56,30,1,8,19,29.6,"DF,FW"
"Aníbal Chalá","2020-2021",31,14,7,50,7,50,10,7,6,3,1,6,12,50,6,5,3,2,14,24,15,1,7,7,50,"DF"
"Thomas Monconduit","2020-2021",11,22,14,63.6,8,36.4,28,15,9,16,3,15,41,36.6,26,10,3,7,13,41,21,1,13,18,41.9,"MF"
"Arkadiusz Milik","2020-2021",74,14,7,50,7,50,14,9,0,7,7,2,12,16.7,10,5,1,4,2,16,9,0,26,30,46.4,"FW"
"Mahdi Camara","2020-2021",57,55,31,56.4,24,43.6,99,67,43,46,10,33,60,55,27,50,12,38,78,177,51,0,45,29,60.8,"MF,DF"
"John Boye","2020-2021",0,4,3,75,1,25,58,34,43,13,2,31,54,57.4,23,36,20,16,80,138,146,1,57,51,52.8,"DF"
"Pape Cheikh Diop","2020-2021",5,17,14,82.4,3,17.6,24,14,15,6,3,13,33,39.4,20,14,2,12,6,30,6,0,9,12,42.9,"MF"
"Patrick Burner","2020-2021",34,22,12,54.5,10,45.5,25,11,14,10,1,13,26,50,13,10,3,7,24,49,41,1,13,21,38.2,"DF"
"Papa Ndiaga Yade","2020-2021",81,45,22,48.9,23,51.1,15,8,9,2,4,7,20,35,13,9,0,9,4,19,6,0,14,29,32.6,"FW,MF"
"Frédéric Sammaritano","2020-2021",76,26,15,57.7,11,42.3,15,10,9,5,1,9,26,34.6,17,6,0,6,9,24,3,0,2,15,11.8,"FW,MF"
"Mathias Pereira Lage","2020-2021",87,39,17,43.6,22,56.4,29,17,12,15,2,10,40,25,30,21,4,17,15,44,16,0,21,39,35,"FW,MF"
"Didier Ibrahim Ndong","2020-2021",28,31,22,71,9,29,53,32,22,30,1,25,70,35.7,45,35,7,28,37,90,40,0,25,29,46.3,"MF"
"Jérémy Le Douaron","2020-2021",68,28,9,32.1,19,67.9,15,10,9,4,2,7,21,33.3,14,14,1,13,8,23,11,0,28,26,51.9,"FW,MF"
"Clément Grenier","2020-2021",63,18,9,50,9,50,20,8,9,8,3,7,31,22.6,24,7,0,7,5,25,3,0,8,12,40,"MF,FW"
"Domagoj Bradarić","2020-2021",93,13,8,61.5,5,38.5,28,18,11,13,4,12,27,44.4,15,14,4,10,26,54,21,0,19,26,42.2,"DF"
"Pape Abou Cissé","2020-2021",1,4,2,50,2,50,15,13,10,5,0,6,10,60,4,7,4,3,27,42,87,0,55,15,78.6,"DF"
"Dan Ndoye","2020-2021",65,17,7,41.2,10,58.8,7,6,3,4,0,1,8,12.5,7,4,0,4,7,14,4,0,5,8,38.5,"FW,MF"
"Timothy Weah","2020-2021",80,15,8,53.3,7,46.7,15,7,3,9,3,7,14,50,7,7,0,7,4,19,5,0,11,20,35.5,"FW,MF"
"Nicolas Cozza","2020-2021",27,20,12,60,8,40,39,30,27,11,1,20,40,50,20,20,11,9,26,65,62,0,15,22,40.5,"DF"
"Damien Le Tallec","2020-2021",8,3,1,33.3,2,66.7,16,10,10,4,2,10,30,33.3,20,15,8,7,25,41,21,2,27,19,58.7,"MF,DF"
"Memphis","2020-2021",329,148,76,51.4,72,48.6,4,3,0,3,1,1,20,5,19,11,1,10,5,9,3,0,14,27,34.1,"FW"
"Danilo Pereira","2020-2021",4,8,7,87.5,1,12.5,21,11,6,11,4,6,14,42.9,8,14,6,8,29,50,33,4,28,16,63.6,"MF,DF"
"Thomas Foket","2020-2021",149,30,18,60,12,40,77,43,50,20,7,40,69,58,29,28,7,21,69,146,92,2,28,42,40,"DF"
"José Fonte","2020-2021",14,6,6,100,0,0,40,29,28,10,2,27,33,81.8,6,36,23,13,36,76,137,1,79,28,73.8,"DF"
"Mathieu Debuchy","2020-2021",91,29,14,48.3,15,51.7,58,33,37,17,4,40,62,64.5,22,27,9,18,45,103,61,0,70,31,69.3,"DF"
"Serhou Guirassy","2020-2021",151,38,24,63.2,14,36.8,4,1,1,3,0,1,3,33.3,2,10,1,9,5,9,17,0,69,56,55.2,"FW"
"Warren Tchimbembé","2020-2021",12,4,4,100,0,0,7,4,4,3,0,3,9,33.3,6,6,1,5,2,9,3,0,6,6,50,"MF,FW"
"Wissam Ben Yedder","2020-2021",226,59,30,50.8,29,49.2,18,9,2,10,6,3,13,23.1,10,16,0,16,13,31,3,0,40,72,35.7,"FW"
"Duje Ćaleta-Car","2020-2021",3,3,2,66.7,1,33.3,29,17,19,9,1,17,30,56.7,13,29,22,7,44,73,130,0,77,35,68.8,"DF"
"Junior Dina Ebimbe","2020-2021",145,113,59,52.2,54,47.8,38,25,14,19,5,15,45,33.3,30,17,1,16,14,52,9,0,17,29,37,"FW,MF"
"Tony Mauricio","2020-2021",25,11,6,54.5,5,45.5,19,12,7,8,4,11,17,64.7,6,8,1,7,3,22,4,0,2,5,28.6,"MF"
"Pablo Sarabia","2020-2021",173,22,8,36.4,14,63.6,15,11,6,6,3,10,38,26.3,28,9,1,8,5,20,8,0,4,11,26.7,"FW,MF"
"Kalifa Coulibaly","2020-2021",70,6,3,50,3,50,3,1,0,1,2,2,8,25,6,3,1,2,2,5,12,0,91,82,52.6,"FW"
"Andrés Cubas","2020-2021",10,17,10,58.8,7,41.2,80,47,30,44,6,33,74,44.6,41,37,10,27,50,130,29,3,4,20,16.7,"MF"
"Haris Duljević","2020-2021",52,49,31,63.3,18,36.7,15,9,4,7,4,6,22,27.3,16,3,0,3,8,23,1,0,11,23,32.4,"MF,FW"
"Lucas Paquetá","2020-2021",99,62,34,54.8,28,45.2,70,36,30,28,12,23,66,34.8,43,28,3,25,20,90,16,1,38,34,52.8,"MF"
"Wout Faes","2020-2021",2,16,12,75,4,25,35,22,26,9,0,20,39,51.3,19,40,31,9,68,103,144,1,57,39,59.4,"DF"
"Kaj Sierhuis","2020-2021",38,15,10,66.7,5,33.3,7,2,1,2,4,2,9,22.2,7,2,1,1,2,9,5,0,13,18,41.9,"FW,MF"
"Lamine Gueye","2020-2021",142,26,15,57.7,11,42.3,18,9,4,11,3,7,24,29.2,17,7,2,5,21,39,5,0,26,42,38.2,"FW,MF"
"Souleyman Doumbia","2020-2021",121,42,25,59.5,17,40.5,48,33,25,19,4,22,36,61.1,14,18,4,14,42,90,50,0,23,21,52.3,"DF"
"Farid Boulaya","2020-2021",116,92,58,63,34,37,24,16,4,17,3,13,51,25.5,38,19,3,16,12,36,7,0,27,42,39.1,"MF,FW"
"Sidy Sarr","2020-2021",5,4,3,75,1,25,10,6,4,6,0,2,5,40,3,1,1,0,7,17,4,0,20,11,64.5,"MF"
"Flavien Tait","2020-2021",92,47,23,48.9,24,51.1,26,11,11,12,3,10,32,31.3,22,17,3,14,13,39,2,0,9,10,47.4,"MF,FW"
"Mihai Dobre","2020-2021",39,23,13,56.5,10,43.5,12,5,6,2,4,7,14,50,7,5,0,5,10,22,3,0,11,10,52.4,"FW"
"Hwang Ui-jo","2020-2021",174,54,26,48.1,28,51.9,14,6,5,8,1,6,25,24,19,17,2,15,8,22,14,0,30,57,34.5,"FW,MF"
"Lamine Koné","2020-2021",2,3,0,0,3,100,9,6,5,4,0,5,8,62.5,3,4,3,1,15,24,36,0,21,18,53.8,"DF"
"Hamari Traoré","2020-2021",236,33,23,69.7,10,30.3,56,38,23,27,6,22,59,37.3,37,31,5,26,76,132,50,0,38,53,41.8,"DF"
"Mehdi Abeid","2020-2021",16,27,19,70.4,8,29.6,34,19,16,14,4,15,30,50,15,9,2,7,20,54,10,0,13,18,41.9,"MF"
"Houssem Aouar","2020-2021",172,81,46,56.8,35,43.2,17,12,0,13,4,8,25,32,17,17,1,16,17,34,4,0,4,17,19,"MF,FW"
"Jérôme Hergault","2020-2021",68,28,10,35.7,18,64.3,38,23,22,10,6,17,31,54.8,14,16,2,14,22,60,34,0,19,26,42.2,"DF,MF"
"Jean Lucas","2020-2021",34,42,32,76.2,10,23.8,22,15,12,10,0,9,33,27.3,24,10,1,9,10,32,11,1,8,16,33.3,"MF"
"Pierre-Yves Hamel","2020-2021",26,4,2,50,2,50,15,8,3,9,3,1,6,16.7,5,12,1,11,10,25,6,0,35,43,44.9,"FW"
"Amine Gouiri","2020-2021",269,103,52,50.5,51,49.5,31,18,7,16,8,10,41,24.4,31,22,6,16,17,48,23,0,20,29,40.8,"FW,MF"
"Timothée Kolodziejczak","2020-2021",5,3,2,66.7,1,33.3,28,15,23,5,0,19,27,70.4,8,24,15,9,36,64,80,1,45,44,50.6,"DF"
"Axel Disasi","2020-2021",4,11,8,72.7,3,27.3,29,20,17,12,0,20,35,57.1,15,18,11,7,26,55,66,1,50,32,61,"DF"
"Mattia De Sciglio","2020-2021",82,21,12,57.1,9,42.9,29,17,15,11,3,18,27,66.7,9,13,4,9,27,56,44,0,19,12,61.3,"DF"
"Presnel Kimpembe","2020-2021",1,12,9,75,3,25,46,28,23,19,4,24,34,70.6,10,19,11,8,30,76,61,4,37,24,60.7,"DF"
"Nicolas de Préville","2020-2021",111,61,34,55.7,27,44.3,19,14,7,6,6,9,42,21.4,33,15,0,15,13,32,7,0,25,29,46.3,"FW,MF"
"Sofiane Boufal","2020-2021",35,68,34,50,34,50,17,11,8,6,3,8,28,28.6,20,8,0,8,3,20,1,0,5,5,50,"FW,MF"
"Tiago Djaló","2020-2021",28,22,7,31.8,15,68.2,22,13,14,5,3,15,23,65.2,8,10,4,6,9,31,23,0,10,7,58.8,"DF"
"Jonathan Bamba","2020-2021",262,119,52,43.7,67,56.3,45,23,15,19,11,24,84,28.6,60,24,2,22,24,69,15,0,15,27,35.7,"MF"
"Rayan Cherki","2020-2021",81,72,49,68.1,23,31.9,5,3,0,3,2,1,11,9.1,10,3,0,3,4,9,0,0,1,5,16.7,"FW,MF"
"Ismaël Traoré","2020-2021",8,16,14,87.5,2,12.5,32,14,23,9,0,20,37,54.1,17,27,13,14,40,72,107,0,36,41,46.8,"DF"
"Florian Miguel","2020-2021",10,4,3,75,1,25,14,13,12,2,0,9,17,52.9,8,21,13,8,45,59,66,1,31,33,48.4,"DF"
"Muzinga Ngonda","2020-2021",96,56,36,64.3,20,35.7,59,40,37,21,1,30,50,60,20,28,3,25,72,131,58,0,31,39,44.3,"DF"
"Samuel Kalu","2020-2021",80,76,36,47.4,40,52.6,21,12,11,8,2,4,13,30.8,9,14,0,14,9,30,2,0,14,12,53.8,"FW,MF"
"Maxime Poundjé","2020-2021",17,10,8,80,2,20,10,7,9,1,0,2,6,33.3,4,7,3,4,11,21,5,0,16,10,61.5,"DF"
"Adil Aouchiche","2020-2021",92,61,34,55.7,27,44.3,38,20,12,17,9,13,49,26.5,36,15,1,14,10,48,6,0,13,28,31.7,"MF,FW"
"Issiaga Sylla","2020-2021",84,28,16,57.1,12,42.9,28,20,11,17,0,11,21,52.4,10,13,3,10,16,44,21,0,27,19,58.7,"DF,MF"
"Josh Maja","2020-2021",57,9,6,66.7,2,22.2,8,2,3,3,2,3,14,21.4,11,3,0,3,6,14,9,0,14,19,42.4,"FW"
"Fábio","2020-2021",59,18,7,38.9,11,61.1,62,37,37,23,2,35,61,57.4,26,29,8,21,37,99,49,0,39,34,53.4,"DF"
"Simon Banza","2020-2021",115,23,9,39.1,14,60.9,13,6,0,4,9,1,14,7.1,13,16,1,15,7,20,15,0,57,63,47.5,"FW"
"Renaud Ripart","2020-2021",152,72,28,38.9,44,61.1,52,30,25,19,8,26,84,31,58,58,12,46,36,88,53,0,72,77,48.3,"MF,FW"
"Arnaud Kalimuendo","2020-2021",132,49,26,53.1,23,46.9,8,2,2,2,4,1,7,14.3,6,11,0,11,2,10,2,0,4,19,17.4,"FW"
"Randal Kolo Muani","2020-2021",206,103,50,48.5,53,51.5,22,14,1,13,8,7,27,25.9,20,15,2,13,8,30,26,0,78,137,36.3,"FW"
"Reinildo Mandava","2020-2021",145,39,28,71.8,11,28.2,79,43,39,32,8,35,58,60.3,23,26,3,23,45,124,53,0,52,17,75.4,"DF"
"Vincent Manceau","2020-2021",103,20,10,50,10,50,42,27,23,17,2,30,63,47.6,33,23,2,21,35,77,61,0,13,11,54.2,"DF"
"Vitorino Hilton","2020-2021",4,1,1,100,0,0,15,10,10,4,1,3,14,21.4,11,34,26,8,38,53,104,3,44,29,60.3,"DF"
"Thiago Mendes","2020-2021",26,23,15,65.2,8,34.8,37,22,13,20,4,18,38,47.4,20,33,7,26,39,76,21,2,25,21,54.3,"MF"
"Steven Nzonzi","2020-2021",46,24,20,83.3,4,16.7,34,16,15,16,3,12,31,38.7,19,24,10,14,16,50,26,0,81,37,68.6,"MF"
"Adrien Thomasson","2020-2021",159,47,24,51.1,23,48.9,36,17,8,16,12,12,58,20.7,46,44,5,39,22,58,2,0,24,65,27,"MF,FW"
"Jonathan Panzo","2020-2021",1,15,14,93.3,1,6.7,17,12,13,4,0,8,11,72.7,3,27,13,14,59,76,91,2,39,24,61.9,"DF"
"Thomas Mangani","2020-2021",36,16,10,62.5,6,37.5,54,37,25,26,3,30,90,33.3,60,31,8,23,38,92,39,0,21,22,48.8,"MF"
"Clément Michelin","2020-2021",64,7,4,57.1,3,42.9,25,19,13,9,3,9,16,56.3,7,13,4,9,25,50,32,0,25,20,55.6,"DF"
"Matthieu Udol","2020-2021",77,31,15,48.4,16,51.6,34,21,18,12,4,17,39,43.6,22,25,5,20,39,73,30,0,17,14,54.8,"DF"
"Boubacar Kamara","2020-2021",44,54,34,63,20,37,88,51,31,49,8,40,74,54.1,34,36,13,23,34,122,51,0,63,42,60,"MF"
"Kasper Dolberg","2020-2021",92,32,11,34.4,21,65.6,6,2,1,3,2,2,11,18.2,9,11,2,9,6,12,19,1,21,19,52.5,"FW"
"Keagan Dolly","2020-2021",19,6,3,50,3,50,7,2,6,0,1,4,8,50,4,3,0,3,5,12,2,0,1,7,12.5,"MF"
"Sven Botman","2020-2021",7,9,7,77.8,2,22.2,31,21,18,12,1,14,26,53.8,12,31,21,10,57,88,126,2,118,55,68.2,"DF"
"Mexer","2020-2021",2,3,3,100,0,0,9,6,8,0,1,5,10,50,5,8,5,3,17,26,22,0,26,11,70.3,"DF"
"Cheick Doucouré","2020-2021",44,47,38,80.9,9,19.1,87,47,40,42,5,32,65,49.2,33,20,4,16,52,139,26,1,25,22,53.2,"MF"
"Jonathan David","2020-2021",173,47,24,51.1,23,48.9,17,10,5,5,7,9,24,37.5,15,19,1,18,3,20,9,0,15,67,18.3,"FW"
"Adrien Hunou","2020-2021",60,3,1,33.3,2,66.7,6,3,2,2,2,2,8,25,6,7,0,7,1,7,2,0,9,13,40.9,"FW,MF"
"Farid El Melali","2020-2021",49,39,22,56.4,17,43.6,9,5,5,4,0,2,13,15.4,11,12,0,12,6,15,2,0,2,8,20,"FW,MF"
"Andy Delort","2020-2021",210,62,31,50,31,50,12,7,1,9,2,8,18,44.4,10,11,1,10,4,16,34,0,135,110,55.1,"FW"
"Hugo Magnetti","2020-2021",1,11,9,81.8,2,18.2,24,12,10,13,1,20,40,50,20,6,1,5,14,38,8,0,3,6,33.3,"MF"
"Robson Bambu","2020-2021",5,6,3,50,3,50,16,11,14,2,0,11,14,78.6,3,8,7,1,10,26,57,0,19,19,50,"DF"
"Jeff Reine-Adélaïde","2020-2021",68,72,45,62.5,27,37.5,7,4,1,4,2,2,9,22.2,7,10,1,9,4,11,6,0,4,10,28.6,"MF,FW"
"Valon Berisha","2020-2021",51,17,10,58.8,7,41.2,40,23,19,17,4,11,47,23.4,36,14,2,12,25,65,21,1,9,13,40.9,"MF"
"Marquinhos","2020-2021",7,2,2,100,0,0,27,21,14,10,3,15,26,57.7,11,21,9,12,27,54,75,2,49,28,63.6,"DF"
"Hiroki Sakai","2020-2021",108,23,9,39.1,14,60.9,81,48,34,35,12,39,51,76.5,12,21,5,16,54,135,65,0,42,38,52.5,"DF"
"Victorien Angban","2020-2021",30,31,21,67.7,10,32.3,36,24,17,15,4,17,42,40.5,25,17,4,13,19,55,9,1,13,18,41.9,"MF"
"Guillermo Maripán","2020-2021",4,2,2,100,0,0,26,11,17,9,0,15,27,55.6,12,18,11,7,27,53,66,1,41,39,51.3,"DF"
"Franck Honorat","2020-2021",227,60,25,41.7,35,58.3,28,13,12,10,6,14,37,37.8,23,15,3,12,11,39,24,0,22,25,46.8,"MF,FW"
"Charles Traore","2020-2021",58,15,5,33.3,10,66.7,53,34,30,17,6,27,54,50,27,26,5,21,36,89,65,0,37,17,68.5,"DF"
"Leandro Paredes","2020-2021",8,7,5,71.4,2,28.6,30,18,12,15,3,19,39,48.7,20,17,5,12,17,47,13,1,10,9,52.6,"MF"
"Jean-Charles Castelletto","2020-2021",3,6,6,100,0,0,32,18,20,11,1,18,31,58.1,13,25,19,6,42,74,79,0,52,24,68.4,"DF"
"Imran Louza","2020-2021",76,25,15,60,10,40,55,28,25,26,4,21,69,30.4,48,20,4,16,33,88,15,2,14,34,29.2,"MF"
"Alessandro Florenzi","2020-2021",148,11,5,45.5,6,54.5,24,16,9,9,6,12,29,41.4,17,7,1,6,17,41,25,0,13,20,39.4,"DF"
"Zaydou Youssouf","2020-2021",28,31,23,74.2,8,25.8,30,15,19,10,1,16,40,40,24,15,0,15,25,55,12,1,7,15,31.8,"MF"
"Marcelo","2020-2021",6,5,3,60,2,40,44,29,30,12,2,26,37,70.3,11,35,25,10,49,93,122,2,111,44,71.6,"DF"
"Ambroise Oyongo","2020-2021",15,6,1,16.7,5,83.3,13,6,10,3,0,9,15,60,6,3,2,1,8,21,26,1,6,4,60,"DF"
"Miguel Trauco","2020-2021",82,28,10,35.7,18,64.3,47,29,25,14,8,23,43,53.5,20,19,4,15,30,77,34,1,22,18,55,"DF"
"Faitout Maouassa","2020-2021",60,34,19,55.9,15,44.1,20,11,10,8,2,11,19,57.9,8,9,1,8,17,37,36,0,14,8,63.6,"DF"
"Stefan Mitrović","2020-2021",0,2,2,100,0,0,36,27,29,7,0,24,37,64.9,13,23,13,10,31,67,108,5,49,38,56.3,"DF"
"Habib Maïga","2020-2021",43,50,34,68,16,32,81,52,36,40,5,42,85,49.4,43,37,6,31,49,130,36,0,39,31,55.7,"MF"
"Moussa Dembélé","2020-2021",45,23,9,39.1,14,60.9,2,2,0,1,1,0,4,0,4,4,2,2,5,7,9,0,18,18,50,"FW"
"Jérémy Morel","2020-2021",17,11,5,45.5,6,54.5,31,19,21,10,0,20,39,51.3,19,26,11,15,44,75,81,1,42,37,53.2,"DF"
"Remi Oudin","2020-2021",210,31,14,45.2,17,54.8,34,16,22,7,5,15,36,41.7,21,22,2,20,51,85,40,1,48,41,53.9,"FW,MF"
"Mihailo Ristić","2020-2021",113,45,22,48.9,23,51.1,45,22,25,13,7,28,44,63.6,16,30,9,21,26,71,57,0,24,28,46.2,"DF"
"Valère Germain","2020-2021",38,5,1,20,4,80,8,6,2,4,2,3,11,27.3,8,7,2,5,11,19,22,0,44,46,48.9,"FW,MF"
"Valentin Rongier","2020-2021",44,38,26,68.4,12,31.6,93,59,31,55,7,43,85,50.6,42,32,2,30,28,121,21,1,25,22,53.2,"MF"
"Fouad Chafik","2020-2021",52,26,16,61.5,10,38.5,39,24,29,8,2,16,35,45.7,19,19,10,9,21,60,41,0,17,24,41.5,"DF"
"Dylan Bronn","2020-2021",7,19,15,78.9,4,21.1,57,37,38,19,0,24,44,54.5,20,31,14,17,44,101,112,0,44,41,51.8,"DF"
"Benjamin André","2020-2021",64,44,29,65.9,15,34.1,114,68,47,61,6,53,122,43.4,69,39,10,29,76,190,49,0,84,83,50.3,"MF"
"Julien Laporte","2020-2021",0,7,6,85.7,1,14.3,65,39,48,16,1,42,74,56.8,32,34,23,11,65,130,125,0,80,50,61.5,"DF"
"Andy Pelmard","2020-2021",10,11,10,90.9,1,9.1,18,12,12,5,1,9,12,75,3,11,3,8,20,38,35,0,10,9,52.6,"DF"
"Xeka","2020-2021",24,13,6,46.2,7,53.8,33,17,14,15,4,16,43,37.2,27,14,2,12,20,53,18,0,16,19,45.7,"MF"
"Stevan Jovetić","2020-2021",80,25,15,60,10,40,8,4,2,3,3,3,13,23.1,10,1,0,1,3,11,3,0,10,20,33.3,"FW,MF"
"Luis Henrique","2020-2021",83,29,13,44.8,16,55.2,5,4,3,1,1,4,9,44.4,5,5,1,4,7,12,4,0,3,0,100,"FW,DF"
"Sada Thioub","2020-2021",115,65,35,53.8,30,46.2,17,14,7,6,4,7,23,30.4,16,10,0,10,9,26,3,0,13,16,44.8,"FW,MF"
"Moreto Cassamã","2020-2021",12,33,27,81.8,6,18.2,49,36,24,23,2,27,49,55.1,22,19,6,13,36,85,33,4,6,13,31.6,"MF"
"Loris Benito","2020-2021",73,3,2,66.7,1,33.3,42,26,27,12,3,22,48,45.8,26,33,10,23,42,84,70,0,43,29,59.7,"DF"
"Yusuf Yazıcı","2020-2021",85,26,13,50,13,50,12,5,6,2,4,1,24,4.2,23,5,1,4,2,14,2,0,4,15,21.1,"FW,MF"
"Laurent Koscielny","2020-2021",3,3,2,66.7,1,33.3,29,17,18,11,0,16,24,66.7,8,44,34,10,54,83,115,1,53,32,62.4,"DF"
"Quentin Boisgard","2020-2021",107,40,25,62.5,15,37.5,24,17,3,15,6,11,24,45.8,13,17,2,15,15,39,1,0,6,17,26.1,"MF,FW"
"Saidou Sow","2020-2021",1,4,3,75,1,25,23,12,17,6,0,13,19,68.4,6,12,8,4,14,37,39,1,24,22,52.2,"DF"
"Dimitri Liénard","2020-2021",87,22,13,59.1,9,40.9,39,27,17,19,3,24,55,43.6,31,23,1,22,18,57,10,0,15,26,36.6,"MF"
"Maxence Caqueret","2020-2021",44,44,33,75,11,25,72,45,17,39,16,35,106,33,71,35,3,32,23,95,5,2,9,12,42.9,"MF"
"Jimmy Briand","2020-2021",22,5,2,40,3,60,7,3,3,2,2,1,1,100,0,2,0,2,1,8,3,0,30,31,49.2,"FW"
"Vincent Pajot","2020-2021",14,8,4,50,4,50,35,20,19,11,5,10,18,55.6,8,9,2,7,42,77,11,0,12,10,54.5,"MF"
"Hicham Boudaoui","2020-2021",70,39,24,61.5,15,38.5,52,35,20,24,8,26,68,38.2,42,14,4,10,23,75,26,1,14,26,35,"MF"
"Luiz Araújo","2020-2021",135,84,49,58.3,35,41.7,38,25,12,18,8,8,28,28.6,20,23,1,22,11,49,3,0,10,20,33.3,"MF"
"Mama Samba Baldé","2020-2021",162,50,19,38,31,62,23,9,4,13,6,9,22,40.9,13,16,1,15,4,27,26,0,58,117,33.1,"FW"
"Yassine Benrahou","2020-2021",53,37,17,45.9,20,54.1,16,9,8,6,2,7,25,28,18,9,0,9,4,20,5,1,6,21,22.2,"MF"
"Jordan Lotomba","2020-2021",115,50,30,60,20,40,35,25,19,11,5,20,34,58.8,14,19,7,12,33,68,52,1,18,27,40,"DF,MF"
"Abdou Diallo","2020-2021",34,26,17,65.4,9,34.6,16,11,9,5,2,8,13,61.5,5,15,8,7,25,41,36,0,23,13,63.9,"DF"
"Moussa Konaté","2020-2021",72,10,5,50,5,50,5,3,1,2,2,2,11,18.2,9,4,1,3,5,10,8,0,23,51,31.1,"FW"
"Dante","2020-2021",0,1,1,100,0,0,10,5,6,4,0,3,7,42.9,4,6,4,2,10,20,20,0,21,7,75,"DF"
"Kelyan Guessoum","2020-2021",1,1,1,100,0,0,13,7,11,1,1,11,16,68.8,5,8,6,2,24,37,51,0,16,12,57.1,"DF"
"Dennis Appiah","2020-2021",81,20,12,60,8,40,55,34,33,15,7,32,59,54.2,27,23,6,17,25,80,43,0,30,23,56.6,"DF"
"Pape Matar Sarr","2020-2021",29,33,18,54.5,15,45.5,45,29,19,21,5,20,38,52.6,18,24,4,20,27,72,16,0,24,14,63.2,"MF"
"Leo Dubois","2020-2021",239,53,30,56.6,23,43.4,38,26,19,16,3,18,36,50,18,27,9,18,31,69,69,2,32,21,60.4,"DF"
"Pol Lirola","2020-2021",128,48,29,60.4,19,39.6,28,16,11,15,2,16,28,57.1,12,18,5,13,25,53,26,0,17,10,63,"DF,FW"
"Islam Slimani","2020-2021",58,9,4,44.4,5,55.6,7,5,3,1,3,3,12,25,9,4,1,3,1,8,6,0,15,18,45.5,"FW"
"Jeremy Doku","2020-2021",281,169,110,65.1,59,34.9,44,25,9,24,11,11,26,42.3,15,18,1,17,11,55,1,0,9,14,39.1,"MF,FW"
"Zinedine Ferhat","2019-2020",198,104,50,48.1,54,51.9,26,16,5,16,5,15,46,32.6,31,15,3,12,16,42,18,0,68,45,60.2,"FW,MF"
"Anthony Caci","2019-2020",20,5,3,60,2,40,29,17,19,9,1,8,17,47.1,9,15,5,10,19,48,15,1,6,9,40,"DF"
"Renato Sanches","2019-2020",64,72,50,69.4,22,30.6,28,15,9,15,4,8,33,24.2,25,19,1,18,15,43,10,1,5,17,22.7,"MF,FW"
"Danilo Barbosa","2019-2020",10,17,13,76.5,4,23.5,28,21,17,9,2,13,29,44.8,16,21,6,15,20,48,38,0,19,18,51.4,"DF,MF"
"Juan Ferney Otero","2019-2020",94,30,10,33.3,20,66.7,17,10,6,9,2,8,24,33.3,16,12,1,11,19,36,10,0,34,46,42.5,"FW,MF"
"Nemanja Radonjić","2019-2020",115,59,36,61,23,39,10,3,4,3,3,6,17,35.3,11,7,0,7,2,12,7,0,5,14,26.3,"FW,MF"
"Benoît Badiashile","2019-2020",4,5,4,80,1,20,18,12,12,5,1,6,12,50,6,20,11,9,27,45,57,1,55,32,63.2,"DF"
"Mickaël Alphonse","2019-2020",45,22,15,68.2,7,31.8,39,25,26,12,1,23,37,62.2,14,19,3,16,17,56,64,0,36,10,78.3,"DF"
"Alaixys Romao","2019-2020",15,20,15,75,5,25,46,29,31,14,1,17,57,29.8,40,12,3,9,26,72,38,3,24,42,36.4,"MF"
"Denis Bouanga","2019-2020",201,123,58,47.2,65,52.8,45,34,10,25,10,20,55,36.4,35,30,0,30,10,55,15,0,39,55,41.5,"FW,MF"
"Romain Hamouma","2019-2020",76,28,12,42.9,16,57.1,12,9,1,5,6,2,12,16.7,10,12,0,12,0,12,4,0,14,23,37.8,"FW,MF"
"Romain Del Castillo","2019-2020",99,60,35,58.3,25,41.7,20,14,5,11,4,6,27,22.2,21,12,2,10,7,27,7,0,20,32,38.5,"FW,MF"
"Jean-Kevin Duverne","2019-2020",4,11,7,63.6,4,36.4,12,8,5,6,1,2,6,33.3,4,23,8,15,20,32,50,0,21,28,42.9,"DF"
"Kévin Denkey","2019-2020",52,9,7,77.8,2,22.2,10,5,1,8,1,6,10,60,4,7,0,7,2,12,1,1,15,29,34.1,"FW"
"Vukašin Jovanović","2019-2020",0,2,0,0,2,100,18,11,12,6,0,14,21,66.7,7,5,3,2,15,33,15,0,9,7,56.3,"DF"
"Ibrahima Sissoko","2019-2020",48,23,10,43.5,13,56.5,46,27,21,21,4,16,48,33.3,32,14,5,9,20,66,25,0,31,22,58.5,"MF"
"Cristian Battocchio","2019-2020",40,14,7,50,7,50,31,24,13,13,5,14,36,38.9,22,13,4,9,19,50,21,0,9,19,32.1,"MF"
"Ryad Boudebouz","2019-2020",97,46,28,60.9,18,39.1,25,16,9,14,2,8,25,32,17,14,1,13,7,32,5,0,11,27,28.9,"MF,FW"
"Jean-Ricner Bellegarde","2019-2020",65,51,33,64.7,18,35.3,40,27,18,19,3,13,21,61.9,8,16,3,13,22,62,6,0,9,26,25.7,"MF"
"Yaya Sanogo","2019-2020",44,3,1,33.3,2,66.7,6,3,2,3,1,1,2,50,1,4,1,3,7,13,14,0,55,73,43,"FW"
"Marco Verratti","2019-2020",43,29,25,86.2,4,13.8,54,32,22,22,10,20,56,35.7,36,23,3,20,19,73,9,0,8,9,47.1,"MF"
"Nicolas Isimat-Mirin","2019-2020",0,1,1,100,0,0,14,8,8,6,0,5,11,45.5,6,18,12,6,22,36,71,0,38,28,57.6,"DF"
"Anthony Briançon","2019-2020",2,6,4,66.7,2,33.3,29,19,20,9,0,17,34,50,17,22,16,6,39,68,80,0,39,32,54.9,"DF"
"Racine Coly","2019-2020",20,9,5,55.6,4,44.4,21,13,15,5,1,9,17,52.9,8,5,0,5,12,33,23,0,15,10,60,"DF,FW"
"Brendan Chardonnet","2019-2020",2,2,2,100,0,0,12,6,10,2,0,7,12,58.3,5,8,5,3,15,27,50,0,31,18,63.3,"DF"
"Gaëtan Charbonnier","2019-2020",162,45,23,51.1,22,48.9,36,16,11,11,14,10,35,28.6,25,19,6,13,7,43,33,1,43,87,33.1,"FW,MF"
"Hassane Kamara","2019-2020",82,53,37,69.8,16,30.2,58,47,40,14,4,24,35,68.6,11,17,2,15,58,116,58,0,26,17,60.5,"DF,FW"
"Ángel Di María","2019-2020",275,133,67,50.4,66,49.6,17,12,2,8,7,4,34,11.8,30,14,3,11,11,28,1,3,1,3,25,"FW,MF"
"Sergi Palencia","2019-2020",21,4,4,100,0,0,16,10,6,10,0,5,7,71.4,2,6,1,5,8,24,4,0,3,11,21.4,"DF"
"Adama Traoré","2019-2020",37,39,28,71.8,11,28.2,3,1,1,2,0,3,12,25,9,7,2,5,4,7,5,0,10,18,35.7,"FW,MF"
"Julian Draxler","2019-2020",51,15,9,60,6,40,13,10,2,9,2,7,15,46.7,8,7,1,6,10,23,1,0,3,1,75,"MF"
"Pablo Martinez","2019-2020",2,6,4,66.7,2,33.3,42,21,26,15,1,21,40,52.5,19,34,22,12,58,100,97,0,52,58,47.3,"DF"
"Dereck Kutesa","2019-2020",52,20,11,55,9,45,6,5,3,2,1,3,9,33.3,6,5,0,5,1,7,1,0,1,8,11.1,"FW,MF"
"Stoppila Sunzu","2019-2020",0,3,2,66.7,1,33.3,16,8,12,4,0,10,15,66.7,5,22,15,7,24,40,63,0,28,22,56,"DF"
"Bafodé Diakité","2019-2020",3,6,4,66.7,2,33.3,23,19,15,8,0,7,13,53.8,6,18,9,9,20,43,75,0,23,23,50,"DF"
"Damien Da Silva","2019-2020",3,8,6,75,2,25,27,14,20,5,2,10,19,52.6,9,21,13,8,26,53,143,1,81,41,66.4,"DF"
"Maxime Lopez","2019-2020",71,28,16,57.1,12,42.9,16,10,5,8,3,4,26,15.4,22,8,2,6,8,24,1,0,1,12,7.7,"MF,FW"
"M'Baye Niang","2019-2020",114,49,16,32.7,33,67.3,17,10,3,11,3,6,21,28.6,15,10,1,9,5,22,20,0,82,87,48.5,"FW"
"Benjamin Bourigeaud","2019-2020",58,16,13,81.3,3,18.8,40,12,18,20,2,17,68,25,51,38,7,31,20,60,25,0,13,26,33.3,"MF"
"Lamine Fomba","2019-2020",27,22,13,59.1,9,40.9,65,31,20,37,8,21,43,48.8,22,29,4,25,25,90,11,1,40,41,49.4,"MF"
"Efthimis Koulouris","2019-2020",108,21,8,38.1,13,61.9,13,8,5,5,3,3,13,23.1,10,8,4,4,3,16,16,0,32,68,32,"FW"
"Jordan Amavi","2019-2020",92,52,30,57.7,22,42.3,55,29,31,19,5,31,64,48.4,33,27,6,21,56,111,97,0,63,23,73.3,"DF"
"Ignatius Ganago","2019-2020",150,39,22,56.4,17,43.6,10,6,4,3,3,3,18,16.7,15,8,1,7,4,14,13,0,13,21,38.2,"FW,MF"
"Otávio","2019-2020",15,21,17,81,4,19,80,45,23,52,5,35,82,42.7,47,26,9,17,41,121,40,6,18,17,51.4,"MF"
"Boulaye Dia","2019-2020",115,48,22,45.8,26,54.2,15,9,7,6,2,3,10,30,7,9,2,7,7,22,16,0,28,84,25,"FW"
"Bakaye Dibassy","2019-2020",11,13,11,84.6,2,15.4,26,14,17,8,1,15,20,75,5,29,18,11,37,63,78,2,25,37,40.3,"DF"
"Junior Sambia","2019-2020",26,15,6,40,9,60,8,6,4,2,2,3,13,23.1,10,4,0,4,8,16,6,0,8,7,53.3,"DF,MF"
"Yacine Adli","2019-2020",47,48,26,54.2,22,45.8,22,14,4,15,3,11,34,32.4,23,10,0,10,8,30,3,0,10,13,43.5,"MF"
"Wahbi Khazri","2019-2020",98,30,16,53.3,14,46.7,17,9,5,7,5,9,27,33.3,18,11,0,11,4,21,0,0,6,20,23.1,"FW,MF"
"Yoann Court","2019-2020",95,23,12,52.2,11,47.8,48,26,28,17,3,20,64,31.3,44,21,0,21,15,63,14,0,11,21,34.4,"FW,MF"
"Romain Thomas","2019-2020",1,3,3,100,0,0,24,17,16,7,1,8,18,44.4,10,35,18,17,39,63,118,1,73,54,57.5,"DF"
"Xavier Chavalerin","2019-2020",53,22,13,59.1,9,40.9,71,52,29,33,9,19,49,38.8,30,23,8,15,36,107,36,0,11,18,37.9,"MF"
"Nayef Aguerd","2019-2020",0,4,3,75,1,25,13,9,7,5,1,8,12,66.7,4,11,11,0,18,31,54,0,43,13,76.8,"DF"
"Thierry Ambrose","2019-2020",49,44,25,56.8,19,43.2,7,5,2,2,3,2,7,28.6,5,3,0,3,3,10,3,0,23,18,56.1,"FW"
"Colin Dagba","2019-2020",55,13,7,53.8,6,46.2,10,4,2,4,4,5,9,55.6,4,6,1,5,6,16,9,0,2,6,25,"DF"
"Pablo","2019-2020",4,7,6,85.7,1,14.3,27,15,22,5,0,16,31,51.6,15,25,14,11,40,67,130,2,112,33,77.2,"DF"
"Aaron Leya Iseka","2019-2020",51,16,9,56.3,7,43.8,2,0,0,2,0,0,3,0,3,5,0,5,1,3,7,0,22,31,41.5,"FW"
"Mathieu Cafaro","2019-2020",75,30,19,63.3,11,36.7,12,6,5,5,2,6,17,35.3,11,13,0,13,2,14,0,0,5,13,27.8,"FW,MF"
"Marshall Munetsi","2019-2020",8,24,15,62.5,9,37.5,27,19,12,12,3,6,12,50,6,13,7,6,12,39,20,1,32,22,59.3,"MF"
"Haris Belkebla","2019-2020",22,25,18,72,7,28,44,24,17,17,10,10,28,35.7,18,25,5,20,53,97,21,2,13,30,30.2,"MF"
"Stephy Mavididi","2019-2020",89,54,29,53.7,25,46.3,18,11,7,8,3,10,26,38.5,16,11,0,11,7,25,5,0,5,27,15.6,"FW,MF"
"Nolan Roux","2019-2020",39,7,2,28.6,5,71.4,5,2,1,3,1,1,3,33.3,2,2,0,2,4,9,5,0,12,23,34.3,"FW"
"Zeki Çelik","2019-2020",99,34,15,44.1,19,55.9,53,28,18,28,7,27,60,45,33,24,4,20,26,79,39,0,24,30,44.4,"DF"
"Yunis Abdelhamid","2019-2020",6,26,20,76.9,6,23.1,46,33,29,15,2,17,30,56.7,13,26,14,12,47,93,99,1,85,51,62.5,"DF"
"Abdoul Kader Bamba","2019-2020",137,106,58,54.7,47,44.3,19,15,5,9,5,9,30,30,21,8,2,6,16,35,8,0,10,13,43.5,"FW,MF"
"Cesc Fàbregas","2019-2020",57,5,4,80,1,20,11,4,6,3,2,6,29,20.7,23,8,1,7,7,18,3,0,15,5,75,"MF"
"Arturo Calabresi","2019-2020",23,40,22,55,18,45,53,33,29,20,4,33,75,44,42,24,11,13,29,82,60,0,30,36,45.5,"DF"
"Christophe Hérelle","2019-2020",11,8,3,37.5,5,62.5,14,11,10,4,0,3,7,42.9,4,14,8,6,17,31,26,1,15,19,44.1,"DF"
"Aleksandr Golovin","2019-2020",115,58,41,70.7,17,29.3,49,27,17,26,6,14,69,20.3,55,28,0,28,31,80,22,0,6,12,33.3,"MF"
"Jordan Ferri","2019-2020",50,32,21,65.6,11,34.4,22,13,7,12,3,13,44,29.5,31,9,0,9,10,32,10,0,10,10,50,"MF"
"Andrei Girotto","2019-2020",2,4,2,50,2,50,76,53,45,29,2,39,71,54.9,32,32,17,15,34,110,111,1,65,49,57,"DF"
"Fabien Centonze","2019-2020",82,53,31,58.5,22,41.5,76,49,53,22,1,34,57,59.6,23,30,11,19,59,135,98,0,39,28,58.2,"DF"
"Ruben Aguilar","2019-2020",80,22,12,54.5,10,45.5,36,22,19,15,2,19,28,67.9,9,6,2,4,11,47,21,0,16,13,55.2,"DF"
"Lebo Mothiba","2019-2020",101,16,11,68.8,5,31.3,4,3,1,1,2,1,6,16.7,5,5,0,5,3,7,1,0,29,36,44.6,"FW"
"Gelson Martins","2019-2020",172,79,53,67.1,26,32.9,30,22,11,15,4,17,42,40.5,25,9,2,7,19,49,10,1,8,14,36.4,"DF,FW"
"Gaëtan Belaud","2019-2020",17,8,4,50,4,50,13,7,10,2,1,4,8,50,4,8,3,5,15,28,15,0,7,12,36.8,"DF"
"Daniel Congré","2019-2020",8,10,6,60,4,40,37,27,20,16,1,18,38,47.4,20,8,7,1,47,84,66,1,49,35,58.3,"DF"
"Haitam Aleesami","2019-2020",72,19,13,68.4,6,31.6,36,16,25,9,2,18,43,41.9,25,33,10,23,34,70,59,1,39,19,67.2,"DF"
"Layvin Kurzawa","2019-2020",80,20,8,40,11,55,23,16,5,14,4,11,23,47.8,12,12,1,11,18,41,24,1,17,16,51.5,"DF"
"Jonathan Ikone","2019-2020",162,119,72,60.5,47,39.5,15,7,3,7,5,6,24,25,18,26,2,24,5,20,3,0,8,17,32,"MF,FW"
"Kylian Mbappé","2019-2020",260,107,55,51.4,52,48.6,7,2,1,5,1,3,10,30,7,4,0,4,3,10,0,0,4,4,50,"FW"
"Juan Bernat","2019-2020",129,39,28,71.8,11,28.2,42,27,19,16,7,20,51,39.2,31,13,1,12,10,52,26,0,9,27,25,"DF,MF"
"Ander Herrera","2019-2020",38,3,2,66.7,1,33.3,19,11,9,9,1,5,14,35.7,9,10,2,8,6,25,4,0,2,1,66.7,"MF,DF"
"Mauro Icardi","2019-2020",64,12,6,50,6,50,4,2,1,3,0,1,10,10,9,7,1,6,2,6,11,0,10,14,41.7,"FW"
"Alexander Djiku","2019-2020",5,17,12,70.6,5,29.4,46,32,27,19,0,21,29,72.4,8,14,8,6,55,101,82,4,60,27,69,"DF,MF"
"Lucas Deaux","2019-2020",24,16,9,56.3,7,43.8,49,26,16,29,4,16,45,35.6,29,20,4,16,15,64,19,0,66,35,65.3,"MF"
"Mounir Chouiar","2019-2020",89,112,70,62.5,42,37.5,36,23,13,18,5,12,42,28.6,30,8,0,8,13,49,13,0,13,13,50,"MF,FW"
"Ludovic Ajorque","2019-2020",137,19,7,36.8,12,63.2,15,10,2,10,3,2,13,15.4,11,11,0,11,2,17,20,0,114,78,59.4,"FW"
"Charles Abi","2019-2020",33,19,13,68.4,6,31.6,9,9,2,5,2,2,7,28.6,5,2,0,2,4,13,4,0,28,34,45.2,"FW"
"Christophe Jallet","2019-2020",31,7,4,57.1,3,42.9,24,16,14,8,2,14,37,37.8,23,8,2,6,18,42,29,0,10,14,41.7,"DF"
"Ibrahima Niane","2019-2020",72,44,20,45.5,24,54.5,8,7,2,5,1,5,16,31.3,11,5,1,4,10,18,11,1,18,45,28.6,"FW"
"Gaëtan Paquiez","2019-2020",40,11,6,54.5,5,45.5,36,25,14,13,9,17,47,36.2,30,18,5,13,33,69,43,0,17,25,40.5,"DF"
"Jason Denayer","2019-2020",3,11,9,81.8,2,18.2,17,13,12,5,0,10,14,71.4,4,32,29,3,20,37,83,0,40,32,55.6,"DF"
"El Bilal Touré","2019-2020",34,6,4,66.7,2,33.3,3,3,1,0,2,0,0,NA,0,6,0,6,1,4,1,0,15,18,45.5,"FW"
"Jean-Eudes Aholou","2019-2020",15,16,12,75,4,25,16,12,2,11,3,3,9,33.3,6,6,1,5,15,31,10,0,10,11,47.6,"MF"
"Angelo Fulgini","2019-2020",76,77,50,64.9,26,33.8,28,18,8,15,5,12,23,52.2,11,6,1,5,19,47,10,0,19,25,43.2,"MF"
"Lois Diony","2019-2020",45,6,1,16.7,5,83.3,15,5,0,11,4,5,9,55.6,4,3,0,3,1,16,0,0,10,25,28.6,"FW"
"Enock Kwateng","2019-2020",40,16,11,68.8,5,31.3,36,22,17,17,2,22,47,46.8,25,16,6,10,22,58,41,0,31,13,70.5,"DF"
"Mamadou Fofana","2019-2020",2,6,3,50,3,50,57,35,38,15,4,21,41,51.2,20,22,10,12,22,79,61,1,19,31,38,"DF,MF"
"Jérémy Gélin","2019-2020",1,1,0,0,1,100,14,5,10,2,2,8,13,61.5,5,14,7,7,15,29,33,1,20,17,54.1,"DF,MF"
"Arnaud Souquet","2019-2020",137,51,23,45.1,28,54.9,62,40,45,13,4,30,67,44.8,37,20,6,14,17,79,44,0,31,33,48.4,"DF,FW"
"Florent Balmont","2019-2020",5,1,1,100,0,0,12,6,5,7,0,7,12,58.3,5,6,0,6,1,13,3,0,2,3,40,"MF"
"Renaud Cohade","2019-2020",30,8,3,37.5,5,62.5,28,20,11,12,5,12,28,42.9,16,14,3,11,8,36,6,0,14,9,60.9,"MF"
"Aurélien Tchouaméni","2019-2020",6,18,15,83.3,3,16.7,30,14,15,13,2,11,29,37.9,18,11,3,8,13,43,21,2,19,10,65.5,"MF"
"Stéphane Bahoken","2019-2020",74,11,5,45.5,6,54.5,7,4,1,2,4,1,7,14.3,6,4,1,3,2,9,2,0,11,36,23.4,"FW"
"Dénys Bain","2019-2020",0,4,3,75,1,25,21,14,15,6,0,9,9,100,0,13,10,3,28,49,66,0,36,19,65.5,"DF"
"Martin Terrier","2019-2020",61,25,17,68,8,32,20,15,7,10,3,3,14,21.4,11,14,1,13,10,30,11,0,20,28,41.7,"FW,MF"
"Thilo Kehrer","2019-2020",5,3,2,66.7,1,33.3,10,7,4,5,1,5,10,50,5,2,0,2,1,11,2,1,8,9,47.1,"DF"
"Sofiane Alakouch","2019-2020",39,33,17,51.5,16,48.5,45,26,25,13,7,25,48,52.1,23,13,2,11,23,68,39,3,10,16,38.5,"DF"
"Arnaud Lusamba","2019-2020",52,24,19,79.2,5,20.8,20,11,8,10,2,7,23,30.4,16,9,0,9,5,25,6,1,3,13,18.8,"MF,FW"
"Paul Lasne","2019-2020",68,9,6,66.7,3,33.3,25,13,13,11,1,6,20,30,14,7,2,5,7,32,5,0,15,13,53.6,"MF,FW"
"Dimitri Payet","2019-2020",144,82,50,61,32,39,22,12,8,8,6,10,26,38.5,16,8,1,7,8,30,12,0,8,8,50,"FW,MF"
"Gaël Kakuta","2019-2020",155,74,48,64.9,26,35.1,46,27,13,27,6,17,48,35.4,31,15,1,14,16,62,8,2,25,61,29.1,"MF,FW"
"Lionel Carole","2019-2020",61,22,14,63.6,8,36.4,23,8,15,6,2,13,17,76.5,4,2,1,1,19,42,22,0,23,7,76.7,"DF"
"Loïc Rémy","2019-2020",72,19,11,57.9,8,42.1,4,1,0,3,1,0,4,0,4,1,1,0,0,4,7,0,12,19,38.7,"FW"
"Irvin Cardona","2019-2020",134,29,14,48.3,15,51.7,13,8,5,6,2,9,32,28.1,23,8,0,8,1,14,7,0,22,18,55,"FW,MF"
"Harold Moukoudi","2019-2020",0,7,5,71.4,2,28.6,28,19,20,7,1,11,14,78.6,3,16,10,6,16,44,42,2,35,17,67.3,"DF"
"Stanley N'Soki","2019-2020",18,36,25,69.4,11,30.6,40,29,24,16,0,23,42,54.8,19,14,6,8,32,72,37,0,21,13,61.8,"DF"
"Ludovic Blas","2019-2020",112,102,59,57.8,43,42.2,26,18,7,15,4,5,26,19.2,21,17,1,16,14,40,11,0,17,35,32.7,"FW,MF"
"Mathieu Dossevi","2019-2020",163,55,31,56.4,24,43.6,32,20,7,17,8,15,30,50,15,17,0,17,14,46,7,0,6,25,19.4,"MF,FW"
"Moussa Doumbia","2019-2020",159,83,40,48.2,43,51.8,16,8,5,6,5,7,24,29.2,17,14,1,13,9,25,5,0,4,19,17.4,"FW,MF"
"Thomas Basila","2019-2020",8,1,1,100,0,0,6,3,2,4,0,4,4,100,0,0,0,0,4,10,14,0,4,5,44.4,"DF"
"Habib Diallo","2019-2020",129,42,21,50,21,50,2,1,0,2,0,0,6,0,6,6,5,1,4,6,43,0,111,154,41.9,"FW"
"Pedro Mendes","2019-2020",3,7,5,71.4,2,28.6,28,17,15,13,0,15,24,62.5,9,19,12,7,28,56,42,1,24,25,49,"DF"
"Gabriel Magalhães","2019-2020",3,2,2,100,0,0,41,29,27,11,3,15,22,68.2,7,27,18,9,22,63,86,2,81,44,64.8,"DF"
"Senou Coulibaly","2019-2020",1,1,1,100,0,0,14,7,11,3,0,2,4,50,2,11,10,1,10,24,44,1,14,7,66.7,"DF"
"Neymar","2019-2020",159,148,90,60.8,58,39.2,12,7,1,9,2,3,21,14.3,18,10,0,10,4,16,1,0,1,4,20,"MF,FW"
"Youcef Atal","2019-2020",119,106,47,44.3,59,55.7,24,11,15,6,3,13,31,41.9,18,12,1,11,24,48,11,1,16,9,64,"FW,DF"
"Loïc Perrin","2019-2020",1,2,2,100,0,0,27,20,16,11,0,11,14,78.6,3,23,17,6,39,66,59,0,59,48,55.1,"DF"
"Ghislain Konan","2019-2020",70,57,27,47.4,30,52.6,43,26,28,14,1,19,28,67.9,9,13,3,10,24,67,34,0,21,33,38.9,"DF"
"Téji Savanier","2019-2020",31,54,33,61.1,21,38.9,52,39,16,30,6,25,77,32.5,52,10,0,10,35,87,21,1,22,13,62.9,"MF"
"Romain Perraud","2019-2020",85,21,12,57.1,9,42.9,29,14,18,9,2,14,28,50,14,24,9,15,27,56,50,0,12,30,28.6,"DF"
"Wesley Lautoa","2019-2020",4,18,15,83.3,3,16.7,54,29,24,28,2,28,63,44.4,35,31,16,15,42,96,48,2,28,24,53.8,"MF,DF"
"Myziane Maolida","2019-2020",120,25,12,48,13,52,14,10,5,6,3,5,12,41.7,7,8,0,8,3,17,3,0,5,6,45.5,"FW,MF"
"Bruno Ecuele Manga","2019-2020",1,7,6,85.7,1,14.3,22,15,17,5,0,9,20,45,11,34,23,11,37,59,112,2,84,39,68.3,"DF"
"Idrissa Gana Gueye","2019-2020",27,40,21,52.5,19,47.5,65,34,30,25,10,18,43,41.9,25,29,4,25,33,98,15,0,17,12,58.6,"MF"
"Alexis Claude-Maurice","2019-2020",142,85,58,68.2,27,31.8,26,16,8,11,7,13,35,37.1,22,20,4,16,11,37,4,0,9,7,56.3,"FW,MF"
"Opa Nguette","2019-2020",143,112,63,56.3,49,43.8,44,28,23,15,6,11,39,28.2,28,17,3,14,12,56,12,0,19,38,33.3,"FW"
"Julien Faussurier","2019-2020",142,17,6,35.3,11,64.7,36,22,23,13,0,21,53,39.6,32,22,7,15,33,69,46,1,18,24,42.9,"DF"
"Kenny Lala","2019-2020",73,68,44,64.7,24,35.3,29,16,17,11,1,11,27,40.7,16,14,5,9,20,49,40,1,16,10,61.5,"DF,MF"
"Kévin Zohi","2019-2020",53,24,15,62.5,9,37.5,8,6,3,3,2,3,6,50,3,1,0,1,4,12,2,0,4,10,28.6,"FW,MF"
"Nicolas Pallois","2019-2020",1,28,21,75,7,25,47,36,28,17,2,31,55,56.4,24,18,13,5,40,87,77,1,44,30,59.5,"DF"
"Joris Chotard","2019-2020",17,15,7,46.7,8,53.3,30,18,13,17,0,15,35,42.9,20,12,5,7,20,50,12,1,22,14,61.1,"MF"
"Pierrick Capelle","2019-2020",102,38,25,65.8,13,34.2,42,32,18,16,8,16,48,33.3,32,17,3,14,21,63,28,0,32,40,44.4,"MF,DF"
"Arnaud Nordin","2019-2020",70,31,19,61.3,12,38.7,7,3,3,3,1,4,13,30.8,9,11,1,10,4,11,6,0,8,28,22.2,"FW,MF"
"Eduardo Camavinga","2019-2020",24,28,19,67.9,9,32.1,105,64,45,56,4,48,96,50,48,26,8,18,34,139,35,0,31,35,47,"MF"
"Jemerson","2019-2020",6,2,2,100,0,0,28,17,13,14,1,10,21,47.6,11,8,3,5,16,44,24,0,12,11,52.2,"DF,MF"
"Gaëtan Laborde","2019-2020",216,80,33,41.3,47,58.8,21,12,4,10,7,9,38,23.7,29,21,0,21,7,28,32,1,113,103,52.3,"FW"
"James Lea Siliki","2019-2020",30,19,12,63.2,7,36.8,28,16,19,9,0,16,29,55.2,13,15,4,11,12,40,12,0,10,9,52.6,"MF"
"Antonin Bobichon","2019-2020",29,10,6,60,4,40,13,7,5,8,0,5,22,22.7,17,8,0,8,8,21,4,0,4,13,23.5,"MF"
"Khéphren Thuram","2019-2020",4,12,8,66.7,4,33.3,22,7,14,8,0,6,17,35.3,11,12,2,10,7,29,13,0,7,3,70,"MF"
"Mathias Autret","2019-2020",83,20,4,20,16,80,23,17,5,11,7,8,25,32,17,14,1,13,10,33,3,0,4,18,18.2,"MF,FW"
"Florent Mollet","2019-2020",122,24,14,58.3,10,41.7,13,11,3,8,2,7,28,25,21,9,1,8,9,22,2,0,12,21,36.4,"MF,FW"
"Abdoulaye Bamba","2019-2020",23,3,1,33.3,2,66.7,10,7,7,1,2,8,15,53.3,7,4,1,3,4,14,18,0,3,8,27.3,"DF"
"Toma Bašić","2019-2020",24,27,19,70.4,8,29.6,26,22,9,16,1,12,27,44.4,15,14,2,12,9,35,12,1,18,8,69.2,"MF"
"Aurélien Chedjou","2019-2020",0,11,9,81.8,2,18.2,27,19,18,9,0,10,22,45.5,12,15,11,4,40,67,120,3,37,36,50.7,"DF"
"François Kamano","2019-2020",69,28,11,39.3,17,60.7,12,6,5,4,3,8,15,53.3,7,5,0,5,3,15,2,0,3,14,17.6,"DF,MF"
"Youssouf Fofana","2019-2020",63,36,15,41.7,21,58.3,41,26,16,22,3,21,45,46.7,24,23,2,21,22,63,16,0,25,16,61,"MF"
"Thomas Delaine","2019-2020",86,29,17,58.6,12,41.4,25,16,18,6,1,12,21,57.1,9,17,1,16,15,40,28,0,6,12,33.3,"DF"
"Thomas Monconduit","2019-2020",21,19,15,78.9,4,21.1,26,12,6,18,2,9,26,34.6,17,11,4,7,10,36,25,3,23,19,54.8,"MF"
"Mahdi Camara","2019-2020",13,10,8,80,2,20,33,20,12,16,5,18,32,56.3,14,20,2,18,18,51,5,0,16,14,53.3,"MF"
"John Boye","2019-2020",0,6,4,66.7,2,33.3,30,19,25,5,0,19,32,59.4,13,31,18,13,31,61,116,0,46,31,59.7,"DF"
"Patrick Burner","2019-2020",32,31,20,64.5,11,35.5,35,25,15,17,3,14,25,56,11,11,2,9,30,65,37,0,8,24,25,"DF"
"Frédéric Sammaritano","2019-2020",41,14,10,71.4,4,28.6,9,7,4,4,1,4,11,36.4,7,6,1,5,2,11,3,1,0,6,0,"MF,FW"
"Mathias Pereira Lage","2019-2020",136,33,13,39.4,20,60.6,30,18,16,13,1,12,37,32.4,25,19,0,19,17,47,9,0,30,35,46.2,"MF"
"Didier Ibrahim Ndong","2019-2020",26,32,19,59.4,13,40.6,62,35,30,31,1,30,59,50.8,29,27,6,21,49,111,31,0,18,26,40.9,"MF"
"Clément Grenier","2019-2020",20,7,6,85.7,1,14.3,21,12,6,15,0,11,40,27.5,29,7,2,5,7,28,16,0,10,6,62.5,"MF"
"Domagoj Bradarić","2019-2020",95,14,6,42.9,8,57.1,28,11,9,17,2,12,27,44.4,15,16,3,13,22,50,28,0,10,22,31.3,"DF"
"Adrien Tameze","2019-2020",24,11,8,72.7,3,27.3,6,2,2,3,1,4,16,25,12,7,2,5,7,13,1,1,2,7,22.2,"MF"
"Nicolas Cozza","2019-2020",1,4,2,50,2,50,5,5,3,2,0,2,3,66.7,1,8,6,2,9,14,18,0,9,9,50,"DF"
"Damien Le Tallec","2019-2020",26,7,3,42.9,4,57.1,52,27,20,28,4,24,69,34.8,45,38,18,20,38,90,59,0,64,65,49.6,"MF,DF"
"Memphis","2019-2020",101,47,26,55.3,21,44.7,4,3,2,0,2,0,5,0,5,0,0,0,2,6,2,0,2,8,20,"FW,MF"
"Robert Berić","2019-2020",23,3,1,33.3,2,66.7,3,2,0,2,1,0,5,0,5,2,0,2,4,7,2,0,3,13,18.8,"FW"
"Nuno da Costa","2019-2020",57,27,16,59.3,11,40.7,15,10,3,8,4,4,10,40,6,7,0,7,4,19,3,0,21,14,60,"FW"
"Thomas Foket","2019-2020",110,21,13,61.9,8,38.1,61,36,31,23,7,30,48,62.5,18,15,4,11,39,100,59,1,21,29,42,"DF"
"José Fonte","2019-2020",8,3,2,66.7,1,33.3,19,11,11,7,1,11,22,50,11,19,11,8,28,47,90,1,64,41,61,"DF"
"Wesley Saïd","2019-2020",84,41,28,68.3,13,31.7,20,9,8,10,2,2,13,15.4,11,6,0,6,9,29,8,0,13,15,46.4,"MF,FW"
"Casimir Ninga","2019-2020",63,20,9,45,11,55,5,5,4,0,1,1,5,20,4,5,0,5,3,8,2,0,13,16,44.8,"MF,FW"
"Mathieu Debuchy","2019-2020",66,17,11,64.7,6,35.3,44,26,22,15,7,24,47,51.1,23,21,11,10,43,87,59,0,90,47,65.7,"DF"
"Serhou Guirassy","2019-2020",178,32,15,46.9,17,53.1,7,3,1,4,2,2,7,28.6,5,13,6,7,4,11,21,0,93,97,48.9,"FW"
"Tristan Dingomé","2019-2020",48,5,3,60,2,40,10,4,3,6,1,2,12,16.7,10,6,0,6,6,16,1,0,2,6,25,"MF"
"William Vainqueur","2019-2020",31,25,21,84,4,16,68,36,30,32,6,22,60,36.7,38,21,5,16,29,97,23,0,20,18,52.6,"MF"
"Wissam Ben Yedder","2019-2020",209,56,34,60.7,22,39.3,22,16,2,12,8,8,19,42.1,11,12,0,12,4,26,1,0,12,34,26.1,"FW"
"Pablo Sarabia","2019-2020",185,9,5,55.6,4,44.4,12,7,3,6,3,4,25,16,21,19,1,18,10,22,5,0,3,9,25,"FW,MF"
"Théo Pellenard","2019-2020",27,8,4,50,4,50,11,8,6,3,2,6,13,46.2,7,4,0,4,5,16,8,0,5,2,71.4,"DF"
"Kalifa Coulibaly","2019-2020",124,27,8,29.6,19,70.4,11,7,0,5,6,3,5,60,2,3,1,2,6,17,32,0,98,91,51.9,"FW"
"Rafael","2019-2020",28,15,8,53.3,7,46.7,24,16,12,8,4,10,18,55.6,8,6,3,3,10,34,14,0,17,9,65.4,"DF"
"Fernando Marçal","2019-2020",50,12,6,50,6,50,28,18,18,7,3,13,26,50,13,7,3,4,26,54,32,0,20,7,74.1,"DF"
"Rayan Aït-Nouri","2019-2020",69,35,19,54.3,16,45.7,29,22,14,8,7,10,21,47.6,11,14,1,13,18,47,33,0,17,6,73.9,"DF"
"Haris Duljević","2019-2020",29,23,13,56.5,10,43.5,11,6,3,7,1,4,12,33.3,8,5,0,5,2,13,1,0,4,10,28.6,"FW,MF"
"Souleyman Doumbia","2019-2020",19,13,8,61.5,5,38.5,11,5,8,2,1,6,7,85.7,1,7,2,5,6,17,21,0,5,8,38.5,"DF"
"Ruben Gabrielsen","2019-2020",0,3,3,100,0,0,3,2,3,0,0,2,4,50,2,5,3,2,8,11,41,0,24,10,70.6,"DF"
"Eddy Gnahoré","2019-2020",32,7,3,42.9,4,57.1,24,12,7,15,2,8,28,28.6,20,25,4,21,9,33,25,0,12,12,50,"MF"
"Farid Boulaya","2019-2020",54,29,15,51.7,14,48.3,14,10,7,4,3,7,19,36.8,12,5,0,5,6,20,3,0,5,13,27.8,"FW"
"Sidy Sarr","2019-2020",21,14,9,64.3,5,35.7,35,18,15,16,4,11,34,32.4,23,13,3,10,15,50,18,0,93,49,65.5,"MF"
"Flavien Tait","2019-2020",67,32,22,68.8,10,31.3,20,13,12,6,2,9,28,32.1,19,7,0,7,9,29,5,1,4,13,23.5,"MF,FW"
"Hwang Ui-jo","2019-2020",112,36,14,38.9,22,61.1,9,7,2,5,2,4,20,20,16,7,0,7,5,14,5,0,15,22,40.5,"FW,MF"
"Molla Wagué","2019-2020",1,4,4,100,0,0,15,12,11,4,0,7,7,100,0,10,8,2,15,30,42,0,27,12,69.2,"DF"
"Lamine Koné","2019-2020",3,10,8,80,2,20,31,21,20,10,1,12,17,70.6,5,8,5,3,25,56,47,1,35,16,68.6,"DF"
"Hamari Traoré","2019-2020",122,41,25,61,16,39,55,26,34,18,3,32,64,50,32,22,5,17,48,103,59,1,37,30,55.2,"DF"
"Mehdi Abeid","2019-2020",42,23,16,69.6,7,30.4,55,29,18,32,5,20,53,37.7,33,16,3,13,23,78,8,1,13,17,43.3,"MF"
"Houssem Aouar","2019-2020",127,112,67,59.8,45,40.2,28,12,6,18,4,10,35,28.6,25,15,1,14,13,41,11,0,17,12,58.6,"MF,FW"
"Jérémy Pied","2019-2020",24,6,3,50,3,50,18,10,6,11,1,11,16,68.8,5,8,0,8,7,25,10,0,4,4,50,"DF"
"Bongani Zungu","2019-2020",4,6,4,66.7,2,33.3,27,11,10,13,4,18,31,58.1,13,8,2,6,16,43,21,0,18,27,40,"MF"
"Timothée Kolodziejczak","2019-2020",21,5,4,80,1,20,17,10,13,4,0,9,21,42.9,12,8,3,5,30,47,44,2,25,18,58.1,"DF"
"Yohan Cabaye","2019-2020",11,8,6,75,2,25,29,18,11,14,4,14,25,56,11,10,0,10,22,51,7,1,8,8,50,"MF"
"Axel Disasi","2019-2020",3,8,4,50,4,50,32,21,18,13,1,17,27,63,10,29,24,5,26,58,97,0,71,50,58.7,"DF"
"Boubakary Soumaré","2019-2020",21,23,20,87,3,13,19,12,6,13,0,9,19,47.4,10,6,0,6,16,35,9,0,10,9,52.6,"MF"
"Presnel Kimpembe","2019-2020",2,15,13,86.7,2,13.3,33,25,25,8,0,14,20,70,6,7,3,4,21,54,33,1,20,12,62.5,"DF"
"Samuel Moutoussamy","2019-2020",42,17,6,35.3,11,64.7,4,1,2,1,1,2,7,28.6,5,2,0,2,4,8,7,0,0,6,0,"DF,MF"
"Nicolas de Préville","2019-2020",159,86,36,41.9,50,58.1,35,21,9,22,4,18,56,32.1,38,15,3,12,6,41,19,0,41,45,47.7,"MF,FW"
"Tiago Djaló","2019-2020",2,4,3,75,1,25,9,4,5,3,1,2,7,28.6,5,3,2,1,11,20,28,0,9,10,47.4,"DF"
"Jonathan Bamba","2019-2020",132,82,45,54.9,37,45.1,12,6,5,5,2,7,29,24.1,22,19,3,16,16,28,8,2,8,12,40,"FW,MF"
"Ismaël Traoré","2019-2020",2,5,4,80,1,20,23,12,14,7,2,10,17,58.8,7,23,13,10,27,50,85,1,40,29,58,"DF"
"Florian Miguel","2019-2020",99,38,15,39.5,23,60.5,51,25,27,20,4,31,52,59.6,21,19,4,15,33,84,32,0,37,34,52.1,"DF"
"Jordan Pefok","2019-2020",21,8,5,62.5,3,37.5,7,6,1,4,2,0,2,0,2,3,0,3,1,8,2,0,16,22,42.1,"FW"
"Muzinga Ngonda","2019-2020",29,4,1,25,3,75,15,6,10,3,2,7,10,70,3,5,4,1,11,26,23,0,11,10,52.4,"DF"
"Nicholas Opoku","2019-2020",1,1,0,0,1,100,7,5,6,1,0,7,14,50,7,6,2,4,7,14,32,0,11,7,61.1,"DF"
"Samuel Kalu","2019-2020",130,96,48,50,47,49,33,17,19,12,2,16,36,44.4,20,13,1,12,24,57,10,0,19,32,37.3,"DF,FW"
"Issiaga Sylla","2019-2020",93,54,31,57.4,23,42.6,73,49,44,21,8,40,69,58,29,31,7,24,67,140,90,2,81,54,60,"DF"
"Fábio","2019-2020",25,9,6,66.7,3,33.3,38,22,18,20,0,25,35,71.4,10,10,5,5,18,56,19,0,15,19,44.1,"DF"
"Kelvin Amian","2019-2020",27,24,11,45.8,13,54.2,27,21,21,5,1,14,25,56,11,14,7,7,18,45,56,0,21,21,50,"DF"
"Ibrahim Sangaré","2019-2020",23,39,30,76.9,9,23.1,84,54,37,42,5,33,74,44.6,41,28,10,18,39,123,49,4,45,23,66.2,"MF"
"Rachid Alioui","2019-2020",108,22,16,72.7,6,27.3,8,5,0,7,1,2,13,15.4,11,3,0,3,2,10,9,0,43,63,40.6,"FW"
"Renaud Ripart","2019-2020",134,56,20,35.7,36,64.3,39,23,17,20,2,18,46,39.1,28,17,2,15,12,51,37,0,78,129,37.7,"FW,DF"
"Maxwel Cornet","2019-2020",159,34,19,55.9,15,44.1,30,19,18,8,4,13,23,56.5,10,16,1,15,21,51,19,1,16,17,48.5,"FW,DF"
"Darío Benedetto","2019-2020",120,27,17,63,10,37,12,9,0,9,3,3,18,16.7,15,15,2,13,3,15,23,1,50,78,39.1,"FW"
"Matheus Pereira da Silva","2019-2020",25,5,3,60,2,40,10,6,1,6,3,4,10,40,6,11,0,11,6,16,5,0,4,5,44.4,"MF,FW"
"Marvin Gakpa","2019-2020",19,8,5,62.5,3,37.5,10,6,3,4,3,4,8,50,4,3,0,3,5,15,1,0,1,6,14.3,"MF,FW"
"Reinildo Mandava","2019-2020",58,14,8,57.1,6,42.9,37,21,23,11,3,25,41,61,16,16,1,15,19,56,20,0,18,18,50,"DF,MF"
"Vincent Manceau","2019-2020",69,14,6,42.9,8,57.1,34,22,18,13,3,16,36,44.4,20,16,3,13,22,56,51,0,15,12,55.6,"DF"
"Jordan Lefort","2019-2020",8,6,5,83.3,1,16.7,3,2,2,1,0,3,5,60,2,4,1,3,9,12,29,0,13,12,52,"DF"
"Youssef Aït Bennasser","2019-2020",6,7,4,57.1,3,42.9,11,8,6,4,1,4,24,16.7,20,6,1,5,4,15,10,1,5,5,50,"MF"
"Vitorino Hilton","2019-2020",6,9,8,88.9,1,11.1,27,17,20,7,0,13,28,46.4,15,22,18,4,49,76,121,1,89,42,67.9,"DF"
"Max Gradel","2019-2020",145,66,36,54.5,30,45.5,36,20,17,14,5,12,47,25.5,35,11,1,10,11,47,23,0,18,35,34,"MF,FW"
"Alexis Blin","2019-2020",9,12,8,66.7,4,33.3,39,25,18,15,6,20,61,32.8,41,25,6,19,16,55,49,0,40,39,50.6,"MF"
"Thiago Mendes","2019-2020",28,14,8,57.1,6,42.9,43,29,20,19,4,21,45,46.7,24,21,7,14,46,89,36,0,13,9,59.1,"MF"
"Adrien Thomasson","2019-2020",149,48,29,60.4,19,39.6,36,21,11,16,9,15,47,31.9,32,21,1,20,9,45,9,0,17,39,30.4,"MF,FW"
"Thomas Mangani","2019-2020",58,24,13,54.2,11,45.8,33,23,15,16,2,14,47,29.8,33,17,2,15,12,45,20,1,25,29,46.3,"MF"
"Theo Valls","2019-2020",35,20,13,65,7,35,39,16,12,26,1,16,50,32,34,17,0,17,13,52,6,0,18,21,46.2,"MF"
"Matthieu Udol","2019-2020",17,22,14,63.6,8,36.4,29,19,19,8,2,13,24,54.2,11,21,4,17,23,52,43,0,13,14,48.1,"DF"
"Boubacar Kamara","2019-2020",3,24,14,58.3,10,41.7,67,34,37,27,3,27,57,47.4,30,27,14,13,34,101,53,1,53,43,55.2,"DF,MF"
"Kasper Dolberg","2019-2020",90,35,13,37.1,22,62.9,10,6,0,3,7,4,17,23.5,13,18,2,16,10,20,24,0,19,21,47.5,"FW"
"Mexer","2019-2020",5,15,9,60,6,40,16,11,14,1,1,10,30,33.3,20,14,13,1,15,31,47,0,44,26,62.9,"DF"
"Adrien Hunou","2019-2020",82,14,5,35.7,9,64.3,21,18,5,11,5,4,21,19,17,16,1,15,5,26,5,0,9,19,32.1,"FW,MF"
"Samuel Grandsir","2019-2020",162,50,24,48,26,52,34,22,13,16,5,11,30,36.7,19,9,0,9,14,48,5,0,5,24,17.2,"FW,MF"
"Andy Delort","2019-2020",246,65,28,43.1,37,56.9,28,18,11,9,8,7,27,25.9,20,21,6,15,3,31,10,0,75,71,51.4,"FW"
"Ludovic Baal","2019-2020",42,25,17,68,8,32,27,15,13,12,2,10,22,45.5,12,9,3,6,17,44,20,0,22,17,56.4,"DF"
"Yann M'Vila","2019-2020",8,6,5,83.3,1,16.7,29,14,12,16,1,12,43,27.9,31,14,4,10,40,69,47,1,33,23,58.9,"MF,DF"
"Jeff Reine-Adélaïde","2019-2020",46,59,44,74.6,15,25.4,13,9,4,5,4,6,14,42.9,8,4,1,3,7,20,5,0,8,9,47.1,"MF"
"Júlio Tavares","2019-2020",134,26,6,23.1,20,76.9,12,8,1,6,5,4,17,23.5,13,9,2,7,8,20,29,0,167,150,52.7,"FW"
"Marquinhos","2019-2020",9,9,7,77.8,2,22.2,39,20,17,18,4,11,26,42.3,15,25,8,17,25,64,31,1,37,34,52.1,"MF,DF"
"Hiroki Sakai","2019-2020",90,24,13,54.2,11,45.8,57,36,26,24,7,25,40,62.5,15,20,5,15,23,80,34,1,32,22,59.3,"DF"
"Romain Amalfitano","2019-2020",28,33,26,78.8,7,21.2,43,27,18,21,4,21,61,34.4,40,23,9,14,36,79,14,2,8,14,36.4,"MF"
"Victorien Angban","2019-2020",17,21,15,71.4,6,28.6,23,18,11,11,1,11,24,45.8,13,9,2,7,8,31,5,0,8,9,47.1,"MF"
"Guillermo Maripán","2019-2020",6,4,2,50,2,50,42,26,28,13,1,24,41,58.5,17,30,13,17,25,67,69,2,39,30,56.5,"DF"
"Franck Honorat","2019-2020",76,14,6,42.9,8,57.1,16,11,7,8,1,8,23,34.8,15,12,1,11,5,21,13,1,6,16,27.3,"FW,DF"
"Charles Traore","2019-2020",23,20,13,65,7,35,48,35,27,19,2,36,61,59,25,21,4,17,39,87,64,0,38,25,60.3,"DF"
"Leandro Paredes","2019-2020",8,10,8,80,2,20,22,14,7,14,1,13,29,44.8,16,7,1,6,15,37,7,0,7,6,53.8,"MF"
"Alexandre Mendy","2019-2020",45,11,8,72.7,3,27.3,5,1,1,0,4,1,4,25,3,4,1,3,0,5,10,0,37,39,48.7,"FW"
"Jean-Charles Castelletto","2019-2020",1,10,10,100,0,0,18,9,13,5,0,9,18,50,9,20,16,4,33,51,87,1,62,42,59.6,"DF"
"Imran Louza","2019-2020",103,39,23,59,16,41,53,27,18,27,8,19,46,41.3,27,18,2,16,17,70,7,0,20,58,25.6,"MF,FW"
"Zaydou Youssouf","2019-2020",12,41,36,87.8,5,12.2,40,22,12,26,2,15,35,42.9,20,7,1,6,16,56,13,0,9,11,45,"MF"
"Ambroise Oyongo","2019-2020",102,38,16,42.1,22,57.9,25,10,16,6,3,16,28,57.1,12,8,0,8,17,42,35,0,24,24,50,"DF,FW"
"Miguel Trauco","2019-2020",48,38,25,65.8,13,34.2,32,20,16,12,4,19,44,43.2,25,8,1,7,23,55,25,0,15,27,35.7,"DF"
"Kévin N'Doram","2019-2020",7,28,18,64.3,10,35.7,43,28,19,21,3,17,40,42.5,23,20,8,12,26,69,23,0,30,28,51.7,"MF"
"Faitout Maouassa","2019-2020",73,50,21,42,29,58,51,33,27,20,4,14,26,53.8,12,13,5,8,23,74,59,0,16,17,48.5,"DF"
"Gil Bastião Dias","2019-2020",71,40,23,57.5,17,42.5,53,33,30,21,2,29,58,50,29,15,1,14,13,66,22,1,14,12,53.8,"DF,MF"
"Stiven Mendoza","2019-2020",86,44,26,59.1,18,40.9,12,7,4,5,3,4,22,18.2,18,13,2,11,9,21,3,1,12,21,36.4,"FW,MF"
"Habib Maïga","2019-2020",64,53,44,83,9,17,84,50,36,38,10,24,64,37.5,40,39,4,35,34,118,39,2,37,45,45.1,"MF"
"Jhonder Cádiz","2019-2020",64,37,19,51.4,18,48.6,16,8,6,7,3,3,7,42.9,4,4,2,2,1,17,9,0,45,39,53.6,"FW,MF"
"Jérémy Morel","2019-2020",19,12,8,66.7,4,33.3,15,9,13,1,1,9,20,45,11,21,17,4,17,32,59,1,36,38,48.6,"DF"
"Remi Oudin","2019-2020",152,30,22,73.3,8,26.7,24,13,12,9,3,10,33,30.3,23,23,2,21,27,51,23,1,22,32,40.7,"FW,MF"
"Mihailo Ristić","2019-2020",43,10,4,40,6,60,18,14,7,11,0,9,20,45,11,7,2,5,7,25,18,0,13,15,46.4,"DF,MF"
"Valère Germain","2019-2020",97,6,3,50,3,50,22,12,6,11,5,6,31,19.4,25,16,3,13,8,30,26,0,35,54,39.3,"FW"
"Valentin Rongier","2019-2020",52,34,30,88.2,4,11.8,81,55,25,43,13,25,68,36.8,43,34,4,30,38,119,16,2,26,17,60.5,"MF"
"Adam Ounas","2019-2020",132,71,45,63.4,26,36.6,10,5,2,6,2,5,13,38.5,8,9,1,8,11,21,8,1,2,14,12.5,"FW,MF"
"Fouad Chafik","2019-2020",52,25,13,52,12,48,32,21,22,7,3,17,36,47.2,19,12,5,7,26,58,36,0,12,12,50,"DF"
"Dylan Bronn","2019-2020",0,3,2,66.7,1,33.3,7,5,6,1,0,4,7,57.1,3,11,9,2,6,13,42,0,13,13,50,"DF"
"Abdoulaye Touré","2019-2020",30,44,31,70.5,13,29.5,32,21,10,21,1,10,30,33.3,20,31,11,20,29,61,18,1,37,39,48.7,"MF"
"Benjamin André","2019-2020",47,25,16,64,9,36,72,44,31,35,6,29,74,39.2,45,32,9,23,59,131,40,1,80,48,62.5,"MF"
"Steven Moreira","2019-2020",43,16,11,68.8,5,31.3,37,25,21,15,1,19,31,61.3,12,16,3,13,16,53,29,0,9,16,36,"DF"
"Andy Pelmard","2019-2020",0,4,2,50,2,50,22,14,13,9,0,9,11,81.8,2,12,4,8,15,37,28,1,4,11,26.7,"DF"
"Xeka","2019-2020",20,6,4,66.7,2,33.3,18,10,3,13,2,9,29,31,20,11,1,10,4,22,7,1,14,17,45.2,"MF"
"Stevan Jovetić","2019-2020",44,20,13,65,7,35,2,1,0,1,1,1,5,20,4,1,0,1,1,3,5,0,8,8,50,"FW,MF"
"Fodé Ballo-Touré","2019-2020",109,37,24,64.9,13,35.1,36,25,21,11,4,17,32,53.1,15,10,1,9,24,60,45,0,14,12,53.8,"DF"
"Sada Thioub","2019-2020",170,95,61,64.2,34,35.8,20,12,8,9,3,5,18,27.8,13,9,1,8,4,24,5,0,10,20,33.3,"MF,FW"
"Pierre Lees-Melou","2019-2020",153,43,25,58.1,18,41.9,63,27,34,21,8,31,88,35.2,57,38,12,26,32,95,43,0,14,13,51.9,"MF"
"Moreto Cassamã","2019-2020",3,16,13,81.3,3,18.8,17,11,2,13,2,5,7,71.4,2,7,2,5,5,22,6,0,5,3,62.5,"MF"
"Loris Benito","2019-2020",73,13,5,38.5,8,61.5,40,25,23,11,6,16,43,37.2,27,14,5,9,29,69,58,1,32,28,53.3,"DF"
"Yusuf Yazıcı","2019-2020",40,23,8,34.8,15,65.2,17,8,2,11,4,5,13,38.5,8,6,1,5,5,22,1,1,0,12,0,"MF,FW"
"Laurent Koscielny","2019-2020",3,5,3,60,2,40,28,13,24,4,0,10,20,50,10,23,19,4,26,54,104,0,51,39,56.7,"DF"
"Quentin Boisgard","2019-2020",61,53,31,58.5,22,41.5,31,19,10,14,7,14,35,40,21,11,0,11,12,43,4,1,13,20,39.4,"MF,FW"
"Dimitri Liénard","2019-2020",45,24,16,66.7,8,33.3,37,24,10,22,5,18,39,46.2,21,18,4,14,17,54,25,0,16,19,45.7,"MF"
"Maxence Caqueret","2019-2020",12,9,6,66.7,3,33.3,24,15,10,13,1,11,25,44,14,14,2,12,9,33,6,1,2,9,18.2,"MF"
"Jimmy Briand","2019-2020",73,14,4,28.6,10,71.4,12,8,5,4,3,3,13,23.1,10,8,4,4,6,18,12,0,33,67,33,"FW"
"Vincent Pajot","2019-2020",20,6,2,33.3,4,66.7,18,13,9,8,1,3,5,60,2,8,1,7,14,32,13,0,10,11,47.6,"MF"
"Romain Philippoteaux","2019-2020",131,57,27,47.4,30,52.6,23,12,11,11,1,9,43,20.9,34,22,1,21,13,36,10,0,2,8,20,"FW,MF"
"Hicham Boudaoui","2019-2020",54,13,5,38.5,8,61.5,20,10,6,11,3,9,23,39.1,14,10,3,7,13,33,7,0,7,11,38.9,"MF,FW"
"Luiz Araújo","2019-2020",60,30,22,73.3,8,26.7,20,11,3,8,9,5,31,16.1,26,14,0,14,4,24,6,0,4,6,40,"FW,MF"
"Mama Samba Baldé","2019-2020",148,52,26,50,26,50,24,13,9,8,7,7,30,23.3,23,17,0,17,7,31,24,0,29,57,33.7,"FW,MF"
"Youssouf Sabaly","2019-2020",53,19,10,52.6,9,47.4,18,11,9,4,5,6,22,27.3,16,8,1,7,18,36,23,0,13,14,48.1,"DF"
"Yassine Benrahou","2019-2020",66,43,21,48.8,22,51.2,16,8,4,4,8,7,21,33.3,14,2,0,2,4,20,1,0,2,17,10.5,"FW,MF"
"Abdou Diallo","2019-2020",10,19,16,84.2,3,15.8,20,11,9,10,1,8,14,57.1,6,9,5,4,10,30,32,0,16,10,61.5,"DF"
"Mohamed Simakan","2019-2020",25,23,16,69.6,7,30.4,54,32,35,16,3,22,34,64.7,12,14,3,11,31,85,25,0,39,25,60.9,"DF"
"Moussa Konaté","2019-2020",42,8,5,62.5,3,37.5,3,0,0,3,0,0,2,0,2,2,0,2,1,4,1,0,14,29,32.6,"FW"
"Dante","2019-2020",1,9,8,88.9,1,11.1,34,21,24,10,0,17,25,68,8,27,16,11,26,60,79,0,51,28,64.6,"DF"
"Dennis Appiah","2019-2020",32,29,22,75.9,7,24.1,58,35,32,20,6,28,52,53.8,24,9,3,6,23,81,34,0,19,17,52.8,"DF"
"Leo Dubois","2019-2020",76,21,11,52.4,10,47.6,32,23,20,9,3,13,22,59.1,9,12,4,8,18,50,34,1,19,6,76,"DF"
"Anthony Caci","2018-2019",51,25,12,48,13,52,56,30,38,14,4,24,46,52.2,22,20,10,10,47,103,63,0,21,31,40.4,"DF"
"Christophe Kerbrat","2018-2019",3,4,3,75,1,25,40,24,28,12,0,24,38,63.2,14,19,10,9,50,90,140,5,30,49,38,"DF"
"Danilo Barbosa","2018-2019",63,53,33,62.3,20,37.7,29,20,13,13,3,6,17,35.3,11,17,2,15,15,44,25,1,18,18,50,"MF"
"Juan Ferney Otero","2018-2019",193,78,37,47.4,40,51.3,29,13,11,12,6,13,46,28.3,33,23,3,20,22,51,18,0,43,63,40.6,"FW,MF"
"Nemanja Radonjić","2018-2019",65,25,11,44,14,56,8,5,1,5,2,5,16,31.3,11,3,0,3,5,13,4,0,3,10,23.1,"FW,MF"
"Jonathan Gradit","2018-2019",24,30,21,70,9,30,52,28,30,21,1,28,52,53.8,24,40,15,25,45,97,82,3,33,56,37.1,"DF"
"Benoît Badiashile","2018-2019",2,1,1,100,0,0,25,18,18,7,0,17,25,68,8,12,5,7,21,46,79,2,36,15,70.6,"DF"
"Enzo Crivelli","2018-2019",123,30,12,40,18,60,20,14,10,8,2,8,13,61.5,5,5,0,5,4,24,28,1,111,130,46.1,"FW"
"Loïck Landre","2018-2019",2,7,4,57.1,3,42.9,31,21,23,8,0,14,22,63.6,8,16,11,5,38,69,83,1,32,38,45.7,"DF"
"Arber Zeneli","2018-2019",94,62,36,58.1,26,41.9,8,6,3,2,3,0,10,0,10,3,0,3,2,10,3,1,2,2,50,"FW"
"Rémi Walter","2018-2019",23,11,5,45.5,6,54.5,20,12,7,10,3,5,15,33.3,10,9,1,8,6,26,11,0,4,11,26.7,"MF"
"Mickaël Alphonse","2018-2019",38,6,4,66.7,2,33.3,10,5,6,1,3,3,4,75,1,3,1,2,9,19,30,0,14,3,82.4,"DF"
"Benjamin Henrichs","2018-2019",135,22,13,59.1,9,40.9,58,39,32,22,4,16,38,42.1,22,18,0,18,35,93,45,0,13,18,41.9,"DF,MF"
"Alaixys Romao","2018-2019",12,39,26,66.7,13,33.3,118,71,61,50,7,43,102,42.2,59,44,16,28,58,176,65,1,61,55,52.6,"MF"
"Denis Bouanga","2018-2019",195,130,50,38.5,80,61.5,52,32,21,22,9,13,61,21.3,48,24,3,21,20,72,16,0,27,74,26.7,"MF,FW"
"Romain Hamouma","2018-2019",152,51,21,41.2,30,58.8,30,19,6,18,6,12,32,37.5,20,12,1,11,9,39,7,0,25,43,36.8,"FW,MF"
"Romain Del Castillo","2018-2019",151,67,36,53.7,31,46.3,36,20,15,13,8,13,37,35.1,24,19,0,19,20,56,7,1,20,24,45.5,"MF,FW"
"Mathías Suárez","2018-2019",21,6,2,33.3,4,66.7,20,11,7,10,3,10,23,43.5,13,11,0,11,9,29,18,0,9,6,60,"DF"
"Jordan Marié","2018-2019",44,17,12,70.6,5,29.4,52,28,15,31,6,21,58,36.2,37,28,5,23,40,92,32,0,20,29,40.8,"MF"
"Eric Maxim Choupo-Moting","2018-2019",81,29,20,69,9,31,9,4,3,2,4,2,9,22.2,7,7,0,7,3,12,4,0,11,19,36.7,"FW"
"Vukašin Jovanović","2018-2019",0,7,5,71.4,2,28.6,26,21,21,5,0,13,19,68.4,6,23,12,11,36,62,105,0,37,38,49.3,"DF"
"Rolando","2018-2019",2,4,2,50,2,50,18,7,15,3,0,8,10,80,2,8,6,2,11,29,25,0,19,18,51.4,"DF"
"Lucas Lima","2018-2019",177,40,22,55,18,45,49,28,26,15,8,20,53,37.7,33,39,3,36,29,78,62,1,39,45,46.4,"DF,FW"
"Ibrahima Sissoko","2018-2019",76,56,33,58.9,23,41.1,60,41,23,34,3,23,55,41.8,32,37,3,34,34,94,39,1,59,48,55.1,"MF"
"Ismaël Diomandé","2018-2019",4,13,8,61.5,5,38.5,28,15,15,12,1,11,20,55,9,17,7,10,10,38,37,0,14,10,58.3,"MF,DF"
"Yaya Sanogo","2018-2019",90,15,4,26.7,11,73.3,4,2,0,2,2,2,4,50,2,3,0,3,3,7,15,0,63,59,51.6,"FW"
"Marco Verratti","2018-2019",38,41,34,82.9,7,17.1,72,42,25,39,8,36,81,44.4,45,26,1,25,18,90,8,2,4,11,26.7,"MF"
"Rémy Cabella","2018-2019",270,106,56,52.8,50,47.2,88,51,31,38,19,30,87,34.5,57,39,1,38,19,107,5,3,15,31,32.6,"MF,FW"
"Anthony Briançon","2018-2019",1,2,2,100,0,0,46,27,36,10,0,27,50,54,23,51,38,13,70,116,184,1,74,60,55.2,"DF"
"Racine Coly","2018-2019",27,14,6,42.9,8,57.1,7,2,1,5,1,4,11,36.4,7,6,1,5,9,16,11,1,13,15,46.4,"DF,MF"
"Khaled Adénon","2018-2019",1,1,1,100,0,0,31,22,20,11,0,16,28,57.1,12,26,11,15,31,62,101,0,51,58,46.8,"DF"
"Félix Eboa Eboa","2018-2019",3,11,9,81.8,2,18.2,47,33,26,20,1,16,22,72.7,6,37,24,13,39,86,136,2,98,51,65.8,"DF"
"Ndombe Mubele","2018-2019",39,19,7,36.8,12,63.2,9,4,5,2,2,4,9,44.4,5,4,0,4,2,11,2,0,4,8,33.3,"FW"
"Sofiane Diop","2018-2019",64,34,14,41.2,20,58.8,12,7,3,6,3,1,15,6.7,14,6,0,6,8,20,6,0,7,11,38.9,"MF,FW"
"Hassane Kamara","2018-2019",17,29,22,75.9,7,24.1,29,21,22,5,2,16,19,84.2,3,6,1,5,14,43,41,0,10,17,37,"DF,FW"
"Ángel Di María","2018-2019",277,84,41,48.8,42,50,29,17,12,10,7,10,42,23.8,32,24,1,23,16,45,4,0,0,2,0,"FW,MF"
"Bouna Sarr","2018-2019",115,102,55,53.9,47,46.1,67,48,27,27,13,26,42,61.9,16,28,3,25,39,106,56,1,35,26,57.4,"DF,MF"
"Julian Draxler","2018-2019",169,58,43,74.1,15,25.9,41,22,11,19,11,16,43,37.2,27,20,1,19,15,56,2,1,18,12,60,"MF,FW"
"Pablo Martinez","2018-2019",7,6,6,100,0,0,51,34,34,17,0,30,49,61.2,19,37,23,14,52,103,132,1,66,44,60,"DF"
"Bafodé Diakité","2018-2019",24,6,0,0,6,100,15,7,5,9,1,10,14,71.4,4,15,3,12,11,26,29,0,22,21,51.2,"DF"
"Cédric Yamberé","2018-2019",4,7,6,85.7,1,14.3,47,31,36,11,0,21,39,53.8,18,45,32,13,52,99,136,4,62,76,44.9,"DF"
"Damien Da Silva","2018-2019",5,10,8,80,2,20,41,25,31,9,1,18,24,75,6,42,36,6,39,80,152,0,76,42,64.4,"DF"
"Ronny Rodelin","2018-2019",48,11,8,72.7,3,27.3,13,5,2,7,4,3,8,37.5,5,8,1,7,8,21,13,0,47,28,62.7,"FW,MF"
"Maxime Lopez","2018-2019",44,25,13,52,12,48,46,24,17,23,6,19,53,35.8,34,10,2,8,20,66,8,0,6,13,31.6,"MF"
"M'Baye Niang","2018-2019",115,52,18,34.6,34,65.4,16,10,3,8,5,2,11,18.2,9,19,3,16,8,24,14,0,53,44,54.6,"FW,MF"
"Benjamin Bourigeaud","2018-2019",167,32,10,31.3,22,68.8,55,35,23,21,11,20,67,29.9,47,44,5,39,32,87,34,1,15,36,29.4,"MF,FW"
"Jordan Amavi","2018-2019",98,43,23,53.5,20,46.5,74,50,34,26,14,35,56,62.5,21,24,8,16,46,120,93,4,71,31,69.6,"DF"
"Jean-Victor Makengo","2018-2019",55,33,26,78.8,7,21.2,10,8,3,6,1,1,5,20,4,5,1,4,9,19,5,0,5,24,17.2,"MF,FW"
"Ganso","2018-2019",26,10,6,60,4,40,12,8,2,8,2,2,15,13.3,13,5,1,4,6,18,0,0,5,4,55.6,"MF,FW"
"Ignatius Ganago","2018-2019",74,25,17,68,8,32,3,1,0,2,1,0,7,0,7,2,0,2,1,4,7,0,23,21,52.3,"FW"
"Otávio","2018-2019",20,23,16,69.6,7,30.4,127,74,59,64,4,49,109,45,60,45,11,34,43,170,54,1,23,37,38.3,"MF"
"Boulaye Dia","2018-2019",63,32,17,53.1,15,46.9,12,6,3,8,1,5,11,45.5,6,4,2,2,4,16,9,0,20,28,41.7,"FW"
"Bakaye Dibassy","2018-2019",68,27,16,59.3,11,40.7,38,26,18,16,4,18,27,66.7,9,40,21,19,44,82,102,0,51,59,46.4,"DF"
"Junior Sambia","2018-2019",77,48,29,60.4,19,39.6,15,7,7,7,1,6,15,40,9,14,2,12,5,20,3,0,12,17,41.4,"MF,FW"
"Paul Baysse","2018-2019",4,1,1,100,0,0,26,14,21,5,0,13,19,68.4,6,26,21,5,32,58,119,1,63,43,59.4,"DF"
"Wahbi Khazri","2018-2019",235,80,46,57.5,34,42.5,41,26,8,14,19,17,49,34.7,32,27,2,25,11,52,5,0,13,48,21.3,"FW,MF"
"Pedro Rebocho","2018-2019",129,30,22,73.3,8,26.7,61,35,31,22,8,29,54,53.7,25,48,13,35,40,101,92,1,44,37,54.3,"DF"
"Xavier Chavalerin","2018-2019",49,31,23,74.2,8,25.8,106,61,56,39,11,28,72,38.9,44,44,12,32,72,178,39,1,10,23,30.3,"MF"
"Younn Zahary","2018-2019",0,5,3,60,2,40,16,9,7,6,3,8,14,57.1,6,13,8,5,16,32,35,0,13,16,44.8,"DF"
"Nayef Aguerd","2018-2019",3,7,6,85.7,1,14.3,17,12,8,9,0,8,19,42.1,11,20,11,9,14,31,59,1,41,23,64.1,"DF"
"Colin Dagba","2018-2019",80,16,10,62.5,6,37.5,24,12,10,12,2,13,19,68.4,6,10,0,10,9,33,10,1,2,11,15.4,"DF,MF"
"Pablo","2018-2019",1,10,8,80,2,20,26,15,22,3,1,13,23,56.5,10,28,22,6,32,58,173,2,71,29,71,"DF"
"Aaron Leya Iseka","2018-2019",95,20,7,35,12,60,6,4,1,4,1,1,4,25,3,5,3,2,1,7,10,0,31,47,39.7,"FW"
"Mathieu Cafaro","2018-2019",133,53,25,47.2,28,52.8,59,28,29,24,6,18,63,28.6,45,28,0,28,20,79,14,0,14,34,29.2,"FW,MF"
"Florian Thauvin","2018-2019",299,116,58,50,57,49.1,42,23,10,21,11,16,35,45.7,19,19,1,18,8,50,4,0,19,30,38.8,"FW,MF"
"Cheick Timite","2018-2019",118,40,20,50,20,50,18,13,5,7,6,3,16,18.8,13,14,2,12,12,30,13,0,21,34,38.2,"FW,MF"
"Naïm Sliti","2018-2019",157,132,83,62.9,49,37.1,56,33,24,19,13,15,46,32.6,31,18,0,18,11,67,9,0,8,31,20.5,"MF,FW"
"Benjamin Jeannot","2018-2019",87,21,14,66.7,7,33.3,17,12,5,7,5,6,19,31.6,13,15,3,12,12,29,14,0,62,80,43.7,"FW,MF"
"Pierre-Yves Polomat","2018-2019",65,20,8,40,12,60,18,13,11,6,1,10,18,55.6,8,4,2,2,21,39,27,0,16,15,51.6,"DF"
"Stef Peeters","2018-2019",7,2,1,50,1,50,15,8,8,4,3,4,11,36.4,7,1,0,1,6,21,1,0,2,0,100,"MF"
"Marcus Coco","2018-2019",186,45,21,46.7,24,53.3,39,23,20,10,9,16,33,48.5,17,24,0,24,23,62,14,0,69,67,50.7,"FW,MF"
"Nicolas Benezet","2018-2019",163,50,34,68,16,32,32,19,14,15,3,5,19,26.3,14,12,0,12,19,51,4,0,19,42,31.1,"MF,FW"
"Kouadio-Yves Dabila","2018-2019",0,1,1,100,0,0,11,6,10,1,0,5,6,83.3,1,13,9,4,6,17,44,0,8,12,40,"DF"
"Nolan Roux","2018-2019",103,13,8,61.5,5,38.5,11,9,0,6,5,4,14,28.6,10,6,2,4,4,15,21,0,47,65,42,"FW"
"Zeki Çelik","2018-2019",181,27,16,59.3,11,40.7,90,59,40,39,11,36,89,40.4,53,34,5,29,34,124,89,1,24,34,41.4,"DF"
"Yunis Abdelhamid","2018-2019",1,23,21,91.3,2,8.7,60,33,48,11,1,30,40,75,10,44,24,20,65,125,196,0,113,71,61.4,"DF"
"Cesc Fàbregas","2018-2019",31,4,3,75,1,25,14,10,5,5,4,8,28,28.6,20,12,3,9,9,23,5,1,7,18,28,"MF"
"Christophe Hérelle","2018-2019",4,14,8,57.1,6,42.9,72,52,51,19,2,40,50,80,10,39,16,23,61,133,158,2,99,56,63.9,"DF"
"Aleksandr Golovin","2018-2019",151,51,29,56.9,22,43.1,36,17,3,20,13,10,44,22.7,34,34,3,31,22,58,12,0,8,22,26.7,"MF,FW"
"Jordan Ferri","2018-2019",64,52,28,53.8,24,46.2,57,34,25,24,8,27,66,40.9,39,31,4,27,16,73,12,1,23,34,40.4,"MF"
"Edgar Ié","2018-2019",12,11,8,72.7,3,27.3,25,17,15,8,2,12,21,57.1,9,12,4,8,15,40,40,0,17,15,53.1,"DF"
"Nathaël Julan","2018-2019",31,8,2,25,6,75,1,0,0,0,1,0,3,0,3,6,1,5,0,1,2,0,38,33,53.5,"FW,MF"
"Andrei Girotto","2018-2019",10,4,2,50,2,50,57,40,18,36,3,20,44,45.5,24,22,6,16,29,86,43,1,55,40,57.9,"MF"
"Ruben Aguilar","2018-2019",155,71,36,50.7,35,49.3,88,51,40,33,15,39,69,56.5,30,23,3,20,37,125,50,1,28,32,46.7,"DF"
"Wylan Cyprien","2018-2019",44,30,19,63.3,11,36.7,40,20,16,21,3,15,43,34.9,28,20,5,15,11,51,15,0,10,10,50,"MF"
"Emmanuel Imorou","2018-2019",30,11,5,45.5,6,54.5,18,13,10,7,1,11,17,64.7,6,14,4,10,28,46,49,1,16,8,66.7,"DF"
"Lebo Mothiba","2018-2019",173,21,13,61.9,8,38.1,11,10,2,8,1,0,8,0,8,5,1,4,0,11,14,0,38,82,31.7,"FW"
"Daniel Congré","2018-2019",20,7,3,42.9,4,57.1,75,45,46,26,3,38,65,58.5,27,35,15,20,67,142,106,1,76,57,57.1,"DF"
"Olivier Boscagli","2018-2019",35,10,6,60,4,40,20,12,14,4,2,9,20,45,11,12,1,11,17,37,37,0,19,18,51.4,"DF"
"Layvin Kurzawa","2018-2019",110,22,12,54.5,10,45.5,19,11,6,5,8,6,16,37.5,10,10,2,8,10,29,16,0,27,13,67.5,"DF,MF"
"Jonathan Ikone","2018-2019",199,123,75,61,48,39,25,14,7,12,6,8,30,26.7,22,24,2,22,6,31,4,0,12,48,20,"MF,FW"
"Kylian Mbappé","2018-2019",311,118,65,55.1,53,44.9,8,4,2,1,5,1,6,16.7,5,2,0,2,5,13,2,0,1,7,12.5,"FW"
"Malang Sarr","2018-2019",25,16,9,56.3,7,43.8,59,36,38,17,4,31,57,54.4,26,29,12,17,68,127,107,2,53,33,61.6,"DF"
"Juan Bernat","2018-2019",152,32,18,56.3,14,43.8,47,32,22,19,6,22,46,47.8,24,19,5,14,20,67,41,1,16,25,39,"DF,MF"
"Alexander Djiku","2018-2019",3,13,8,61.5,5,38.5,48,37,33,13,2,23,43,53.5,20,56,31,25,83,131,183,3,83,53,61,"DF"
"Lucas Deaux","2018-2019",39,14,5,35.7,9,64.3,41,28,21,18,2,20,41,48.8,21,10,0,10,11,52,7,0,30,38,44.1,"MF"
"Mateo Pavlović","2018-2019",4,1,1,100,0,0,26,18,24,2,0,12,24,50,12,37,29,8,20,46,164,2,60,42,58.8,"DF"
"Ludovic Ajorque","2018-2019",126,18,10,55.6,8,44.4,17,13,1,10,6,4,9,44.4,5,5,0,5,5,22,9,0,104,60,63.4,"FW"
"John Bostock","2018-2019",12,6,1,16.7,5,83.3,24,14,14,10,0,9,30,30,21,12,2,10,17,41,11,0,14,10,58.3,"MF"
"Jonas Martin","2018-2019",46,27,19,70.4,8,29.6,46,28,23,18,5,17,33,51.5,16,30,12,18,30,76,42,0,17,19,47.2,"MF"
"Abdul Majeed Waris","2018-2019",239,68,27,39.7,41,60.3,22,13,6,13,3,7,28,25,21,9,0,9,7,29,7,0,13,35,27.1,"FW,MF"
"Christophe Jallet","2018-2019",46,2,1,50,1,50,29,21,12,13,4,16,27,59.3,11,21,5,16,14,43,32,0,9,13,40.9,"DF"
"Gaëtan Paquiez","2018-2019",30,13,7,53.8,6,46.2,43,29,30,10,3,23,48,47.9,25,24,6,18,22,65,50,0,18,18,50,"DF"
"Jason Denayer","2018-2019",3,18,11,61.1,7,38.9,33,21,22,11,0,16,24,66.7,8,36,32,4,26,59,122,1,54,45,54.5,"DF"
"Jean-Eudes Aholou","2018-2019",27,17,10,58.8,7,41.2,20,11,6,11,3,8,16,50,8,7,0,7,17,37,12,0,22,25,46.8,"MF"
"Mehdi Merghem","2018-2019",49,30,17,56.7,13,43.3,25,18,15,7,3,11,21,52.4,10,14,1,13,9,34,6,0,8,7,53.3,"FW,MF"
"Gabriel Silva","2018-2019",75,13,9,69.2,4,30.8,19,10,13,6,0,6,17,35.3,11,15,3,12,14,33,60,1,30,29,50.8,"DF"
"Kévin Monnet-Paquet","2018-2019",97,42,21,50,21,50,46,25,23,16,7,20,36,55.6,16,22,4,18,14,60,28,0,28,65,30.1,"DF,MF"
"Angelo Fulgini","2018-2019",127,46,19,41.3,27,58.7,38,22,18,13,7,12,31,38.7,19,21,3,18,28,66,15,0,19,22,46.3,"MF,FW"
"Lois Diony","2018-2019",157,31,15,48.4,16,51.6,17,12,3,9,5,4,10,40,6,14,0,14,1,18,9,0,27,55,32.9,"FW"
"Enock Kwateng","2018-2019",108,41,23,56.1,18,43.9,65,41,34,27,4,33,70,47.1,37,28,4,24,78,143,56,0,41,27,60.3,"DF"
"Jérémy Gélin","2018-2019",1,7,6,85.7,1,14.3,30,16,18,10,2,18,34,52.9,16,14,6,8,19,49,29,0,13,22,37.1,"DF,MF"
"Ole Selnæs","2018-2019",19,14,11,78.6,3,21.4,44,26,12,23,9,13,35,37.1,22,24,7,17,19,63,29,0,23,28,45.1,"MF"
"Florent Balmont","2018-2019",13,4,4,100,0,0,29,16,16,10,3,9,36,25,27,13,2,11,6,35,8,0,1,7,12.5,"MF"
"Aurélien Tchouaméni","2018-2019",7,10,6,60,4,40,24,12,10,14,0,7,18,38.9,11,11,5,6,21,45,14,0,11,17,39.3,"MF"
"Stéphane Bahoken","2018-2019",173,17,6,35.3,11,64.7,15,7,0,10,5,3,21,14.3,18,35,3,32,8,23,5,0,38,78,32.8,"FW"
"Martin Terrier","2018-2019",116,23,14,60.9,9,39.1,23,13,5,13,5,9,23,39.1,14,17,2,15,6,29,14,0,23,26,46.9,"FW"
"Jaroslav Plašil","2018-2019",31,13,10,76.9,3,23.1,34,26,11,20,3,18,44,40.9,26,21,5,16,19,53,28,1,27,29,48.2,"MF"
"Sanjin Prcić","2018-2019",11,15,12,80,3,20,19,14,11,7,1,8,18,44.4,10,22,8,14,18,37,7,1,11,8,57.9,"MF"
"Thilo Kehrer","2018-2019",44,4,4,100,0,0,64,43,27,31,6,31,55,56.4,24,32,17,15,31,95,69,1,52,35,59.8,"DF"
"Edinson Cavani","2018-2019",122,21,12,57.1,9,42.9,11,8,1,4,6,3,13,23.1,10,11,2,9,6,17,16,0,4,12,25,"FW"
"Sofiane Alakouch","2018-2019",64,34,21,61.8,13,38.2,81,44,44,31,6,36,63,57.1,27,15,4,11,46,127,57,0,18,26,40.9,"DF"
"Paul Lasne","2018-2019",72,23,12,52.2,11,47.8,53,33,32,16,5,24,43,55.8,19,22,2,20,22,75,23,1,22,17,56.4,"MF,DF"
"Dimitri Payet","2018-2019",149,30,18,60,12,40,11,9,2,8,1,5,22,22.7,17,14,0,14,8,19,8,0,4,10,28.6,"MF,FW"
"Nacer Chadli","2018-2019",51,16,8,50,8,50,11,5,4,4,3,3,8,37.5,5,7,1,6,3,14,7,0,16,7,69.6,"MF,DF"
"Lionel Carole","2018-2019",99,26,10,38.5,16,61.5,25,12,16,7,2,11,16,68.8,5,19,5,14,32,57,51,0,27,30,47.4,"DF,FW"
"Loïc Rémy","2018-2019",60,6,5,83.3,1,16.7,2,1,0,2,0,0,3,0,3,3,1,2,2,4,17,1,36,47,43.4,"FW"
"Tanguy Ndombele","2018-2019",61,88,64,72.7,24,27.3,66,43,21,35,10,22,54,40.7,32,29,9,20,30,96,13,3,18,12,60,"MF"
"Emiliano Sala","2018-2019",99,15,3,20,12,80,7,5,0,2,5,1,8,12.5,7,8,1,7,2,9,20,0,42,61,40.8,"FW"
"Frederic Guilbert","2018-2019",86,50,29,58,21,42,98,67,59,29,10,41,83,49.4,42,49,21,28,78,176,121,2,76,76,50,"DF"
"Baptiste Santamaria","2018-2019",20,44,28,63.6,16,36.4,118,60,48,63,7,51,106,48.1,55,41,4,37,57,175,57,2,37,39,48.7,"MF"
"Lucas Evangelista","2018-2019",61,21,10,47.6,11,52.4,30,17,11,12,7,14,25,56,11,10,0,10,9,39,6,0,23,16,59,"FW,MF"
"Gerzino Nyamsi","2018-2019",1,4,2,50,2,50,6,3,5,1,0,4,9,44.4,5,8,4,4,4,10,17,0,21,10,67.7,"DF"
"Stanley N'Soki","2018-2019",43,18,13,72.2,5,27.8,20,14,8,10,2,6,13,46.2,7,10,1,9,18,38,20,1,16,6,72.7,"DF"
"Ludovic Blas","2018-2019",81,86,57,66.3,29,33.7,62,38,22,32,8,20,43,46.5,23,44,7,37,26,88,14,0,42,76,35.6,"MF,FW"
"Mathieu Dossevi","2018-2019",256,91,40,44,51,56,42,28,20,11,11,13,40,32.5,27,29,1,28,33,75,13,0,13,32,28.9,"FW,MF"
"Moussa Doumbia","2018-2019",128,62,32,51.6,30,48.4,28,13,13,13,2,11,39,28.2,28,7,2,5,7,35,13,0,13,29,31,"FW,MF"
"Radamel Falcao","2018-2019",166,34,14,41.2,20,58.8,34,15,6,16,12,8,27,29.6,19,11,6,5,3,37,23,2,92,96,48.9,"FW"
"Pedro Mendes","2018-2019",5,12,11,91.7,1,8.3,71,42,56,13,2,31,47,66,16,42,22,20,48,119,73,1,34,52,39.5,"DF"
"Gabriel Magalhães","2018-2019",0,1,0,0,1,100,18,11,13,4,1,4,7,57.1,3,14,6,8,19,37,60,2,41,16,71.9,"DF"
"Senou Coulibaly","2018-2019",0,1,1,100,0,0,13,7,10,3,0,3,8,37.5,5,8,2,6,11,24,20,0,10,10,50,"DF"
"Ihsan Sacko","2018-2019",38,8,3,37.5,5,62.5,7,2,2,5,0,2,5,40,3,5,0,5,2,9,2,0,4,15,21.1,"FW"
"Neymar","2018-2019",138,124,75,60.5,48,38.7,14,9,3,10,1,4,21,19,17,8,0,8,5,19,1,1,8,3,72.7,"MF,FW"
"Youcef Atal","2018-2019",275,203,101,49.8,102,50.2,68,44,34,25,9,34,67,50.7,33,38,8,30,56,124,42,0,44,41,51.8,"DF,FW"
"Loïc Perrin","2018-2019",3,9,6,66.7,3,33.3,53,36,34,17,2,20,33,60.6,13,37,24,13,44,97,118,2,91,47,65.9,"DF"
"Ghislain Konan","2018-2019",57,53,25,47.2,28,52.8,45,28,31,10,4,24,40,60,16,18,4,14,40,85,55,1,23,38,37.7,"DF"
"Igor Lewczuk","2018-2019",2,1,0,0,1,100,12,7,8,2,2,1,4,25,3,2,2,0,4,16,27,0,13,10,56.5,"DF"
"Enzo Loiodice","2018-2019",5,8,4,50,4,50,25,14,8,15,2,10,21,47.6,11,7,0,7,11,36,7,0,7,8,46.7,"MF"
"Téji Savanier","2018-2019",41,118,79,66.9,39,33.1,95,58,35,52,8,43,116,37.1,73,32,15,17,64,159,53,2,44,46,48.9,"MF"
"François Moubandje","2018-2019",79,32,16,50,16,50,38,22,22,10,6,17,22,77.3,5,18,4,14,27,65,74,0,39,37,51.3,"DF"
"Umut Bozok","2018-2019",74,25,12,48,13,52,9,6,0,3,6,2,4,50,2,3,0,3,5,14,1,0,18,38,32.1,"FW"
"Wesley Lautoa","2018-2019",8,17,13,76.5,4,23.5,81,55,46,31,4,34,75,45.3,41,37,14,23,87,168,110,1,51,62,45.1,"DF,MF"
"Morgan Sanson","2018-2019",96,57,33,57.9,24,42.1,70,47,27,35,8,21,77,27.3,56,40,1,39,42,112,8,1,23,40,36.5,"MF"
"Rui Fonte","2018-2019",40,3,1,33.3,2,66.7,25,12,4,16,5,6,11,54.5,5,4,0,4,2,27,8,0,37,29,56.1,"FW,MF"
"Myziane Maolida","2018-2019",113,45,19,42.2,26,57.8,12,8,5,5,2,2,4,50,2,5,0,5,1,13,5,0,9,19,32.1,"FW"
"Pelé","2018-2019",7,8,8,100,0,0,8,7,3,5,0,2,6,33.3,4,2,1,1,3,11,10,0,7,5,58.3,"MF"
"Hatem Ben Arfa","2018-2019",114,207,116,56,91,44,15,7,4,8,3,7,16,43.8,9,9,0,9,4,19,0,0,5,11,31.3,"FW,MF"
"Kenny Lala","2018-2019",169,83,36,43.4,47,56.6,78,45,48,23,7,30,53,56.6,23,26,9,17,28,106,62,2,24,36,40,"DF,FW"
"Kévin Zohi","2018-2019",68,35,14,40,21,60,14,10,6,6,2,5,9,55.6,4,8,0,8,7,21,5,0,9,16,36,"FW,MF"
"Jérémy Sorbon","2018-2019",0,5,5,100,0,0,33,20,23,10,0,14,22,63.6,8,33,23,10,34,67,105,2,55,54,50.5,"DF"
"Nicolas Pallois","2018-2019",7,29,22,75.9,7,24.1,77,48,60,17,0,40,69,58,29,30,14,16,34,111,114,0,47,42,52.8,"DF"
"Kenny Tete","2018-2019",99,6,1,16.7,5,83.3,30,23,11,16,3,13,19,68.4,6,13,5,8,18,48,29,0,18,19,48.6,"DF"
"Kwon Chang-hoon","2018-2019",83,34,18,52.9,16,47.1,7,4,3,2,2,0,12,0,12,16,0,16,8,15,8,0,16,22,42.1,"FW,MF"
"Saîf-Eddine Khaoui","2018-2019",60,41,24,58.5,17,41.5,20,14,5,11,4,8,27,29.6,19,9,1,8,20,40,4,0,11,18,37.9,"FW,MF"
"Pierrick Capelle","2018-2019",74,27,18,66.7,9,33.3,51,31,23,22,6,19,54,35.2,35,23,2,21,38,89,49,0,30,29,50.8,"DF,MF"
"Arnaud Nordin","2018-2019",95,37,22,59.5,15,40.5,14,12,4,4,6,4,11,36.4,7,13,2,11,5,19,9,0,11,16,40.7,"FW,MF"
"Prince-Désir Gouano","2018-2019",1,1,1,100,0,0,31,18,25,5,1,12,22,54.5,10,36,27,9,46,77,127,6,66,43,60.6,"DF"
"Jemerson","2018-2019",1,2,1,50,1,50,54,38,34,19,1,29,46,63,17,29,17,12,25,79,121,1,63,35,64.3,"DF,MF"
"Gaëtan Laborde","2018-2019",247,102,43,42.2,59,57.8,40,18,6,16,18,13,31,41.9,18,18,2,16,6,46,27,0,101,116,46.5,"FW"
"James Lea Siliki","2018-2019",75,33,12,36.4,21,63.6,26,17,13,10,3,12,35,34.3,23,14,1,13,10,36,7,1,3,7,30,"MF,FW"
"Antonin Bobichon","2018-2019",45,33,17,51.5,16,48.5,34,16,17,12,5,16,58,27.6,42,15,3,12,15,49,13,0,17,38,30.9,"MF"
"Corentin Jean","2018-2019",54,13,5,38.5,8,61.5,9,6,3,6,0,2,8,25,6,8,0,8,2,11,5,0,13,27,32.5,"FW,MF"
"Florent Mollet","2018-2019",228,51,20,39.2,31,60.8,36,20,8,20,8,13,51,25.5,38,32,1,31,23,59,7,0,15,33,31.3,"MF"
"Abdoulaye Bamba","2018-2019",79,26,15,57.7,11,42.3,51,29,31,14,6,24,44,54.5,20,20,4,16,37,88,86,0,22,28,44,"DF"
"Suk Hyun-jun","2018-2019",46,11,6,54.5,5,45.5,11,8,1,6,4,0,8,0,8,2,1,1,2,13,4,1,69,57,54.8,"FW"
"Toma Bašić","2018-2019",58,30,18,60,12,40,32,16,5,21,6,11,31,35.5,20,13,1,12,9,41,22,1,31,28,52.5,"MF"
"Yeni Ngbakoto","2018-2019",36,5,2,40,3,60,9,4,4,3,2,4,8,50,4,7,0,7,4,13,2,0,12,13,48,"MF,FW"
"François Kamano","2018-2019",221,82,39,47.6,43,52.4,29,18,6,17,6,11,30,36.7,19,27,0,27,17,46,6,1,6,19,24,"FW,MF"
"Neven Subotić","2018-2019",2,4,3,75,1,25,44,23,36,7,1,20,39,51.3,19,14,6,8,38,82,107,3,41,18,69.5,"DF"
"Youssouf Fofana","2018-2019",21,25,16,64,9,36,28,20,5,20,3,9,27,33.3,18,7,0,7,11,39,8,0,5,7,41.7,"MF"
"Luiz Gustavo","2018-2019",14,19,15,78.9,4,21.1,72,43,49,18,5,30,66,45.5,36,26,12,14,34,106,61,0,16,22,42.1,"MF,DF"
"Kara Mbodji","2018-2019",1,1,0,0,1,100,12,10,10,1,1,6,8,75,2,4,1,3,6,18,25,0,16,8,66.7,"DF"
"Bassem Srarfi","2018-2019",85,36,22,61.1,14,38.9,20,11,8,8,4,6,17,35.3,11,8,0,8,5,25,5,0,8,12,40,"FW,MF"
"Thomas Monconduit","2018-2019",31,54,34,63,20,37,76,47,38,33,5,26,63,41.3,37,46,17,29,36,112,77,1,48,36,57.1,"MF"
"Thiago Silva","2018-2019",4,2,2,100,0,0,16,13,7,8,1,6,11,54.5,5,28,20,8,32,48,99,1,48,22,68.6,"DF"
"Pape Cheikh Diop","2018-2019",15,6,4,66.7,2,33.3,1,0,0,1,0,0,5,0,5,6,2,4,2,3,2,1,2,8,20,"MF"
"Patrick Burner","2018-2019",49,33,13,39.4,20,60.6,36,23,22,10,4,16,34,47.1,18,15,5,10,31,67,40,0,11,16,40.7,"DF"
"Frédéric Sammaritano","2018-2019",31,8,2,25,6,75,11,5,5,5,1,5,13,38.5,8,8,1,7,8,19,2,1,0,12,0,"FW,MF"
"Didier Ibrahim Ndong","2018-2019",12,11,6,54.5,5,45.5,16,11,3,13,0,5,13,38.5,8,15,3,12,15,31,6,1,14,23,37.8,"MF"
"Jean-Clair Todibo","2018-2019",0,6,5,83.3,1,16.7,21,18,19,2,0,11,13,84.6,2,14,5,9,14,35,62,2,24,17,58.5,"DF"
"Gen Shoji","2018-2019",1,4,4,100,0,0,24,13,16,8,0,11,24,45.8,13,22,14,8,21,45,56,0,21,22,48.8,"DF"
"Clément Grenier","2018-2019",62,37,23,62.2,14,37.8,44,27,7,33,4,21,61,34.4,40,28,4,24,29,73,34,1,18,18,50,"MF"
"Carlos Vinícius","2018-2019",31,17,10,58.8,7,41.2,4,1,1,2,1,0,1,0,1,7,0,7,1,5,2,0,13,22,37.1,"FW,MF"
"Yann Karamoh","2018-2019",102,81,44,54.3,37,45.7,7,3,1,4,2,1,13,7.7,12,9,0,9,6,13,3,0,0,16,0,"FW"
"Jules Keita","2018-2019",63,39,16,41,23,59,10,4,0,3,7,5,12,41.7,7,2,0,2,2,12,1,0,2,8,20,"FW,MF"
"Adrien Tameze","2018-2019",60,67,40,59.7,27,40.3,74,44,32,31,11,39,92,42.4,53,53,12,41,56,130,59,1,32,39,45.1,"MF"
"Adil Rami","2018-2019",6,5,4,80,1,20,14,9,12,2,0,8,12,66.7,4,14,14,0,18,32,52,3,59,19,75.6,"DF"
"Nicolas Cozza","2018-2019",14,14,8,57.1,6,42.9,19,15,14,5,0,4,10,40,6,13,10,3,23,42,37,1,14,19,42.4,"DF"
"Damien Le Tallec","2018-2019",28,8,2,25,6,75,95,58,42,43,10,33,89,37.1,56,35,8,27,59,154,50,0,79,70,53,"MF"
"Memphis","2018-2019",281,104,60,57.7,44,42.3,12,9,0,7,5,5,21,23.8,16,16,2,14,9,21,1,0,12,16,42.9,"FW,MF"
"Jordan Ikoko","2018-2019",73,23,16,69.6,7,30.4,37,24,22,14,1,16,28,57.1,12,18,5,13,24,61,30,0,7,22,24.1,"DF"
"Robert Berić","2018-2019",52,15,5,33.3,10,66.7,12,5,1,9,2,1,11,9.1,10,8,2,6,4,16,3,0,31,49,38.8,"FW"
"Nuno da Costa","2018-2019",180,70,33,47.1,37,52.9,39,27,10,19,10,10,38,26.3,28,24,1,23,14,53,9,0,52,67,43.7,"FW"
"Thomas Foket","2018-2019",110,21,11,52.4,10,47.6,91,52,55,23,13,42,69,60.9,27,30,4,26,49,140,80,1,28,41,40.6,"DF"
"José Fonte","2018-2019",12,6,4,66.7,2,33.3,27,15,15,9,3,17,24,70.8,7,33,26,7,37,64,153,1,117,40,74.5,"DF"
"Wesley Saïd","2018-2019",160,67,45,67.2,22,32.8,25,18,6,11,8,5,20,25,15,9,0,9,9,34,9,0,19,33,36.5,"FW,MF"
"Thiago Maia","2018-2019",8,6,4,66.7,2,33.3,32,19,17,13,2,13,33,39.4,20,14,5,9,23,55,23,0,14,18,43.8,"MF"
"Casimir Ninga","2018-2019",185,126,52,41.3,74,58.7,53,30,23,21,9,20,49,40.8,29,22,1,21,22,75,12,0,30,68,30.6,"FW,MF"
"Mathieu Debuchy","2018-2019",105,24,9,37.5,15,62.5,43,26,25,13,5,22,37,59.5,15,17,7,10,47,90,64,0,92,50,64.8,"DF"
"Tristan Dingomé","2018-2019",78,23,9,39.1,14,60.9,27,15,11,10,6,7,24,29.2,17,16,3,13,11,38,5,0,7,16,30.4,"MF"
"Baptiste Guillaume","2018-2019",61,14,10,71.4,4,28.6,12,6,1,8,3,2,9,22.2,7,6,0,6,2,14,6,0,84,71,54.2,"FW"
"Théo Pellenard","2018-2019",30,10,8,80,2,20,11,6,7,2,2,5,8,62.5,3,6,2,4,5,16,16,0,10,3,76.9,"DF"
"Kalifa Coulibaly","2018-2019",132,34,19,55.9,15,44.1,15,7,1,10,4,4,11,36.4,7,8,1,7,4,19,22,0,141,102,58,"FW"
"Rafael","2018-2019",63,20,11,55,9,45,31,19,14,12,5,17,24,70.8,7,19,2,17,15,46,30,2,17,15,53.1,"DF"
"Rene Krhin","2018-2019",0,7,4,57.1,3,42.9,22,14,7,12,3,11,19,57.9,8,7,4,3,21,43,32,0,34,14,70.8,"MF"
"Fernando Marçal","2018-2019",39,6,1,16.7,5,83.3,25,16,17,7,1,12,15,80,3,9,3,6,30,55,42,0,34,26,56.7,"DF"
"Valentin Rosier","2018-2019",79,26,16,61.5,10,38.5,44,25,22,19,3,16,31,51.6,15,25,4,21,32,76,45,1,18,14,56.3,"DF,MF"
"Souleyman Doumbia","2018-2019",22,14,7,50,7,50,11,7,9,2,0,6,10,60,4,6,1,5,4,15,20,0,11,8,57.9,"DF"
"Guessouma Fofana","2018-2019",9,4,2,50,2,50,20,13,5,13,2,5,13,38.5,8,5,1,4,9,29,8,0,10,10,50,"MF"
"Yoël Armougom","2018-2019",49,31,11,35.5,20,64.5,31,21,20,9,2,15,29,51.7,14,9,3,6,21,52,66,0,26,27,49.1,"DF"
"Prince Oniangué","2018-2019",20,7,2,28.6,5,71.4,59,33,22,34,3,24,57,42.1,33,30,10,20,29,88,42,0,48,45,51.6,"MF"
"Oualid El Hajjam","2018-2019",18,8,5,62.5,3,37.5,14,9,10,3,1,5,15,33.3,10,8,2,6,12,26,26,0,12,8,60,"DF,MF"
"Thomas Fontaine","2018-2019",0,1,1,100,0,0,6,3,5,0,1,2,5,40,3,6,2,4,7,13,28,1,10,9,52.6,"DF,MF"
"Eddy Gnahoré","2018-2019",63,37,23,62.2,14,37.8,39,27,17,17,5,9,39,23.1,30,29,4,25,23,62,23,1,29,27,51.8,"MF"
"Flavien Tait","2018-2019",279,148,82,55.4,66,44.6,58,35,33,16,9,23,59,39,36,29,2,27,28,86,15,0,12,18,40,"MF,FW"
"Yacine Bammou","2018-2019",63,6,3,50,3,50,14,7,7,4,3,3,8,37.5,5,14,3,11,9,23,17,0,20,25,44.4,"FW,MF"
"Lamine Koné","2018-2019",6,10,8,80,2,20,21,16,9,9,3,6,9,66.7,3,18,13,5,33,54,66,3,55,30,64.7,"DF"
"Hamari Traoré","2018-2019",142,52,26,50,26,50,61,33,32,27,2,36,71,50.7,35,39,11,28,44,105,82,0,35,58,37.6,"DF"
"Mehdi Abeid","2018-2019",50,60,31,51.7,29,48.3,51,33,27,16,8,15,45,33.3,30,33,7,26,29,80,23,1,17,26,39.5,"MF"
"Houssem Aouar","2018-2019",163,97,58,59.8,39,40.2,63,38,28,25,10,17,61,27.9,44,33,6,27,32,95,25,3,17,33,34,"MF"
"Jessy Deminguet","2018-2019",17,22,14,63.6,8,36.4,37,25,18,17,2,15,40,37.5,25,19,3,16,18,55,28,1,12,13,48,"MF"
"Jérémy Pied","2018-2019",30,4,2,50,2,50,12,8,5,6,1,3,9,33.3,6,8,1,7,5,17,13,0,8,15,34.8,"DF"
"Baissama Sankoh","2018-2019",21,16,5,31.3,11,68.8,4,1,4,0,0,1,4,25,3,8,1,7,5,9,16,0,11,15,42.3,"MF,FW"
"Timothée Kolodziejczak","2018-2019",56,19,12,63.2,7,36.8,34,22,21,10,3,20,45,44.4,25,25,11,14,53,87,118,2,44,45,49.4,"DF"
"Boubakary Soumaré","2018-2019",10,11,8,72.7,3,27.3,20,15,9,11,0,10,18,55.6,8,9,3,6,7,27,5,0,6,9,40,"MF"
"Presnel Kimpembe","2018-2019",6,13,5,38.5,8,61.5,55,34,26,25,4,24,40,60,16,17,10,7,30,85,48,5,24,26,48,"DF"
"Samuel Moutoussamy","2018-2019",93,26,16,61.5,10,38.5,35,20,16,11,8,12,34,35.3,22,17,2,15,9,44,17,0,9,19,32.1,"MF,FW"
"Nicolas de Préville","2018-2019",115,58,22,37.9,36,62.1,28,19,10,15,3,8,29,27.6,21,23,1,22,10,38,21,1,30,37,44.8,"FW,MF"
"Jonathan Bamba","2018-2019",265,76,34,44.7,42,55.3,29,19,7,17,5,13,39,33.3,26,24,1,23,41,70,18,0,27,36,42.9,"FW,MF"
"Wilfried Kanga","2018-2019",46,6,4,66.7,2,33.3,0,0,0,0,0,0,1,0,1,3,0,3,0,0,4,0,11,17,39.3,"FW"
"Ismaël Traoré","2018-2019",5,9,6,66.7,3,33.3,27,11,19,8,0,9,24,37.5,15,27,16,11,42,69,120,2,31,40,43.7,"DF"
"Florian Miguel","2018-2019",19,8,3,37.5,5,62.5,19,16,13,6,0,7,11,63.6,4,15,7,8,21,40,47,0,17,26,39.5,"DF"
"Jordan Pefok","2018-2019",36,6,1,16.7,5,83.3,6,2,0,3,3,2,4,50,2,7,2,5,4,10,5,0,19,18,51.4,"FW"
"Lebogang Phiri","2018-2019",16,19,12,63.2,7,36.8,60,38,16,41,3,24,43,55.8,19,26,3,23,29,89,19,0,12,16,42.9,"MF"
"Samuel Kalu","2018-2019",134,89,46,51.7,43,48.3,27,18,15,7,5,4,11,36.4,7,11,3,8,8,35,4,1,21,32,39.6,"FW"
"Maxime Poundjé","2018-2019",107,28,15,53.6,13,46.4,48,35,34,12,2,31,62,50,31,24,5,19,29,77,79,0,40,39,50.6,"DF"
"Adama Mbengue","2018-2019",20,13,8,61.5,5,38.5,48,32,34,12,2,19,26,73.1,7,15,4,11,7,55,22,0,5,11,31.3,"DF"
"Issiaga Sylla","2018-2019",105,33,16,48.5,17,51.5,54,36,30,24,0,28,53,52.8,25,36,10,26,39,93,77,0,58,45,56.3,"DF,MF"
"Fábio","2018-2019",55,14,8,57.1,6,42.9,53,34,25,27,1,26,53,49.1,27,18,4,14,18,71,27,0,20,17,54.1,"DF,FW"
"Kelvin Amian","2018-2019",59,39,24,61.5,15,38.5,68,45,54,12,2,20,30,66.7,10,36,13,23,36,104,113,1,47,49,49,"DF"
"Ibrahim Sangaré","2018-2019",36,71,50,70.4,21,29.6,102,66,50,44,8,32,63,50.8,31,52,20,32,29,131,49,2,39,29,57.4,"MF"
"Rachid Alioui","2018-2019",79,12,7,58.3,5,41.7,15,5,3,9,3,4,9,44.4,5,8,1,7,10,25,11,0,42,67,38.5,"FW"
"Renaud Ripart","2018-2019",187,50,17,34,33,66,76,49,41,22,13,32,76,42.1,44,43,7,36,27,103,79,0,95,140,40.4,"FW,DF"
"Maxwel Cornet","2018-2019",198,52,23,44.2,29,55.8,14,11,4,7,3,1,11,9.1,10,10,0,10,5,19,8,0,19,27,41.3,"FW"
"Cheick Traoré","2018-2019",99,41,16,39,25,61,37,21,23,11,3,15,25,60,10,13,3,10,23,60,46,1,18,24,42.9,"DF"
"Ismaila Sarr","2018-2019",272,131,62,47.3,69,52.7,35,24,16,15,4,17,34,50,17,17,2,15,14,49,4,0,21,37,36.2,"FW,MF"
"Vincent Manceau","2018-2019",98,22,13,59.1,9,40.9,98,65,64,23,11,33,62,53.2,29,41,10,31,44,142,87,0,18,20,47.4,"DF"
"Anthony Gonçalves","2018-2019",77,9,7,77.8,2,22.2,22,15,12,8,2,7,22,31.8,15,21,2,19,10,32,17,0,13,13,50,"MF,FW"
"Stéphane Mbia","2018-2019",1,1,1,100,0,0,1,0,1,0,0,1,2,50,1,9,4,5,7,8,25,1,10,9,52.6,"DF,MF"
"Jordan Lefort","2018-2019",40,12,8,66.7,4,33.3,33,18,23,6,4,16,25,64,9,11,8,3,46,79,107,0,61,30,67,"DF"
"Youssef Aït Bennasser","2018-2019",25,30,23,76.7,7,23.3,58,29,23,30,5,26,57,45.6,31,30,7,23,34,92,25,2,14,20,41.2,"MF"
"Bertrand Traoré","2018-2019",288,90,52,57.8,38,42.2,36,22,19,13,4,12,26,46.2,14,23,5,18,15,51,18,0,23,33,41.1,"FW"
"Vitorino Hilton","2018-2019",5,4,3,75,1,25,33,13,28,5,0,12,30,40,18,31,15,16,66,99,198,2,77,48,61.6,"DF"
"Max Gradel","2018-2019",349,162,88,54.3,74,45.7,58,35,34,19,5,24,70,34.3,46,53,9,44,18,76,41,0,40,77,34.2,"FW,MF"
"Kamil Glik","2018-2019",2,3,2,66.7,1,33.3,32,23,26,5,1,16,32,50,16,25,17,8,61,93,200,1,95,78,54.9,"DF"
"Younousse Sankharé","2018-2019",52,49,29,59.2,20,40.8,25,12,2,19,4,6,19,31.6,13,14,0,14,9,34,4,0,16,17,48.5,"MF"
"Andreas Cornelius","2018-2019",58,8,5,62.5,3,37.5,4,1,1,3,0,1,4,25,3,4,1,3,1,5,21,0,74,50,59.7,"FW"
"Alexis Blin","2018-2019",20,9,5,55.6,4,44.4,77,45,33,36,8,35,89,39.3,54,39,14,25,33,110,48,1,48,49,49.5,"MF"
"Kostas Mitroglou","2018-2019",22,4,1,25,3,75,0,0,0,0,0,0,3,0,3,0,0,0,0,0,5,0,11,14,44,"FW"
"Thiago Mendes","2018-2019",44,43,28,65.1,15,34.9,85,47,42,41,2,39,71,54.9,32,44,11,33,68,153,49,0,24,36,40,"MF"
"Adrien Thomasson","2018-2019",193,32,21,65.6,11,34.4,54,27,18,23,13,21,66,31.8,45,29,5,24,18,72,12,1,14,45,23.7,"MF,FW"
"Thomas Mangani","2018-2019",42,11,8,72.7,3,27.3,42,27,13,26,3,19,62,30.6,43,13,2,11,23,65,24,0,12,30,28.6,"MF"
"Theo Valls","2018-2019",35,13,7,53.8,6,46.2,37,21,16,19,2,15,43,34.9,28,17,4,13,22,59,15,0,22,27,44.9,"MF"
"Mehdi Zeffane","2018-2019",61,10,4,40,6,60,19,13,12,7,0,10,26,38.5,16,14,5,9,18,37,35,1,17,19,47.2,"DF,MF"
"Dani Alves","2018-2019",131,30,16,53.3,14,46.7,42,22,16,23,3,13,38,34.2,25,18,5,13,8,50,11,0,11,18,37.9,"MF,DF"
"Boubacar Kamara","2018-2019",7,15,10,66.7,5,33.3,67,39,38,24,5,32,49,65.3,17,24,13,11,45,112,95,2,61,48,56,"DF"
"Anthony Limbombe","2018-2019",125,23,11,47.8,12,52.2,12,10,4,6,2,7,16,43.8,9,5,0,5,8,20,10,0,13,17,43.3,"FW"
"Mexer","2018-2019",2,13,12,92.3,1,7.7,23,12,18,5,0,12,18,66.7,6,26,18,8,30,53,125,0,60,35,63.2,"DF"
"Benjamin Corgnet","2018-2019",45,14,8,57.1,6,42.9,21,12,7,9,5,4,11,36.4,7,1,0,1,6,27,9,0,22,24,47.8,"MF,FW"
"Adrien Hunou","2018-2019",78,15,3,20,12,80,11,7,3,5,3,2,9,22.2,7,14,0,14,5,16,8,0,11,24,31.4,"FW,MF"
"Samuel Grandsir","2018-2019",95,36,20,55.6,16,44.4,21,13,9,8,4,5,17,29.4,12,13,0,13,2,23,5,1,5,11,31.3,"MF,FW"
"Étienne Didot","2018-2019",35,7,4,57.1,3,42.9,41,29,12,27,2,17,44,38.6,27,37,10,27,37,78,35,0,23,37,38.3,"MF"
"Andy Delort","2018-2019",345,94,54,57.4,40,42.6,34,20,7,20,7,8,34,23.5,26,28,7,21,4,38,7,0,127,159,44.4,"FW"
"Yann M'Vila","2018-2019",8,14,11,78.6,3,21.4,72,40,22,48,2,29,72,40.3,43,42,12,30,74,146,86,5,44,40,52.4,"MF"
"Jeff Reine-Adélaïde","2018-2019",145,151,93,61.6,58,38.4,40,22,18,19,3,16,39,41,23,20,0,20,19,59,10,0,17,27,38.6,"FW,MF"
"Júlio Tavares","2018-2019",150,23,11,47.8,12,52.2,15,9,1,7,7,3,9,33.3,6,17,3,14,13,28,51,0,231,225,50.7,"FW"
"Marquinhos","2018-2019",13,7,6,85.7,1,14.3,65,41,34,28,3,31,52,59.6,21,30,13,17,44,109,84,1,68,39,63.6,"DF,MF"
"Hiroki Sakai","2018-2019",111,20,12,60,8,40,59,41,30,23,6,29,54,53.7,25,25,10,15,37,96,77,0,82,34,70.7,"DF"
"Adrien Silva","2018-2019",9,25,15,60,10,40,50,31,19,26,5,30,62,48.4,32,15,2,13,16,66,23,0,21,15,58.3,"MF"
"Romain Amalfitano","2018-2019",62,51,27,52.9,24,47.1,52,33,20,28,4,25,67,37.3,42,45,13,32,47,99,35,0,13,35,27.1,"MF,FW"
"Moussa Sylla","2018-2019",74,18,8,44.4,10,55.6,6,4,4,1,1,2,6,33.3,4,5,2,3,2,8,5,0,16,35,31.4,"FW,MF"
"Petar Škuletić","2018-2019",38,11,8,72.7,3,27.3,9,5,4,2,3,1,15,6.7,14,7,1,6,3,12,14,1,47,27,63.5,"FW"
"Hervé Lybohy","2018-2019",1,1,1,100,0,0,22,13,13,9,0,11,16,68.8,5,17,11,6,14,36,70,0,28,30,48.3,"DF"
"Valentín Vada","2018-2019",11,9,4,44.4,5,55.6,9,5,4,5,0,4,13,30.8,9,4,1,3,7,16,4,0,1,5,16.7,"MF"
"Charles Traore","2018-2019",34,3,1,33.3,2,66.7,40,20,22,16,2,23,34,67.6,11,16,3,13,19,59,46,0,26,18,59.1,"DF,FW"
"Aly Ndom","2018-2019",3,10,5,50,5,50,11,9,5,5,1,3,7,42.9,4,6,2,4,4,15,10,1,10,11,47.6,"MF"
"Leandro Paredes","2018-2019",6,9,5,55.6,4,44.4,34,19,16,15,3,13,30,43.3,17,17,5,12,14,48,20,2,10,8,55.6,"MF"
"Alexandre Mendy","2018-2019",37,9,4,44.4,5,55.6,5,3,0,4,1,3,8,37.5,5,3,0,3,1,6,6,0,21,37,36.2,"FW"
"Thomas Meunier","2018-2019",151,16,8,50,8,50,44,33,25,15,4,21,35,60,14,13,2,11,19,63,29,0,34,18,65.4,"DF"
"Zaydou Youssouf","2018-2019",19,9,7,77.8,2,22.2,7,5,3,4,0,3,7,42.9,4,5,1,4,5,12,0,0,5,10,33.3,"MF,FW"
"Marcelo","2018-2019",4,8,8,100,0,0,48,33,29,17,2,19,24,79.2,5,30,22,8,62,110,152,2,171,45,79.2,"DF"
"Ambroise Oyongo","2018-2019",109,54,29,53.7,25,46.3,44,21,23,16,5,20,38,52.6,18,26,6,20,38,82,60,0,13,34,27.7,"DF"
"Baba Rahman","2018-2019",21,26,13,50,13,50,26,20,17,8,1,18,21,85.7,3,21,3,18,16,42,37,2,21,25,45.7,"DF"
"Jakob Johansson","2018-2019",3,8,4,50,4,50,17,9,5,12,0,10,20,50,10,7,3,4,3,20,17,1,19,8,70.4,"MF"
"Clément Depres","2018-2019",31,3,2,66.7,1,33.3,2,2,1,1,0,1,4,25,3,3,0,3,0,2,6,0,52,33,61.2,"FW"
"Faitout Maouassa","2018-2019",67,51,23,45.1,28,54.9,55,30,35,15,5,23,39,59,16,24,5,19,23,78,81,1,20,12,62.5,"DF"
"Stefan Mitrović","2018-2019",0,3,3,100,0,0,23,16,20,3,0,12,24,50,12,41,31,10,46,69,146,2,67,45,59.8,"DF"
"Stiven Mendoza","2018-2019",140,73,41,56.2,32,43.8,29,18,10,12,7,14,38,36.8,24,18,0,18,17,46,12,0,8,14,36.4,"FW,MF"
"Youssouf Koné","2018-2019",76,27,17,63,10,37,67,38,45,19,3,41,65,63.1,24,31,3,28,39,106,52,1,13,25,34.2,"DF"
"Moussa Dembélé","2018-2019",164,43,27,62.8,16,37.2,12,4,0,8,4,4,14,28.6,10,15,2,13,2,14,13,0,50,51,49.5,"FW"
"Gabriel Boschilia","2018-2019",82,29,14,48.3,15,51.7,33,23,11,9,13,8,33,24.2,25,14,2,12,8,41,7,0,5,22,18.5,"FW,MF"
"Remi Oudin","2018-2019",202,32,12,37.5,20,62.5,51,32,25,18,8,20,45,44.4,25,29,5,24,42,93,34,0,28,59,32.2,"FW,MF"
"Valère Germain","2018-2019",111,8,3,37.5,5,62.5,38,25,8,22,8,8,33,24.2,25,20,5,15,6,44,30,0,98,146,40.2,"FW"
"Kalidou Sidibé","2018-2019",4,5,4,80,1,20,24,12,11,12,1,7,15,46.7,8,16,3,13,17,41,26,1,64,31,67.4,"MF"
"Oussama Haddadi","2018-2019",183,23,11,47.8,12,52.2,51,25,38,11,2,24,43,55.8,19,33,8,25,45,96,93,2,28,42,40,"DF"
"Malik Tchokounté","2018-2019",61,24,15,62.5,9,37.5,21,13,6,12,3,5,10,50,5,11,0,11,6,27,26,0,89,82,52,"FW,MF"
"Valentin Rongier","2018-2019",126,56,37,66.1,19,33.9,86,54,24,46,16,26,65,40,39,46,6,40,33,119,19,0,35,46,43.2,"MF"
"Fouad Chafik","2018-2019",68,32,17,53.1,15,46.9,44,31,29,12,3,23,36,63.9,13,17,3,14,25,69,71,0,16,22,42.1,"DF"
"Kevin Strootman","2018-2019",33,13,10,76.9,3,23.1,76,40,21,47,8,20,52,38.5,32,24,6,18,24,100,26,0,40,39,50.6,"MF"
"Abdoulaye Touré","2018-2019",55,59,42,71.2,17,28.8,48,31,14,28,6,19,56,33.9,37,25,10,15,47,95,29,1,47,52,47.5,"MF"
"Benjamin André","2018-2019",86,32,21,65.6,11,34.4,101,60,39,50,12,33,85,38.8,52,40,6,34,54,155,58,0,141,98,59,"MF"
"Jimmy Durmaz","2018-2019",110,87,49,56.3,38,43.7,34,22,8,13,13,15,38,39.5,23,14,2,12,11,45,16,1,9,24,27.3,"MF,FW"
"Steven Moreira","2018-2019",38,11,5,45.5,6,54.5,19,8,13,5,1,10,17,58.8,7,14,0,14,10,29,19,1,5,14,26.3,"DF,MF"
"Cheikh N'Doye","2018-2019",91,10,5,50,5,50,25,15,14,11,0,10,32,31.3,22,33,8,25,25,50,61,0,174,69,71.6,"MF"
"Christopher Jullien","2018-2019",11,7,4,57.1,3,42.9,35,24,23,10,2,12,32,37.5,20,39,27,12,41,76,203,4,140,49,74.1,"DF"
"Xeka","2018-2019",19,16,8,50,8,50,59,31,25,27,7,18,57,31.6,39,20,2,18,21,80,30,4,38,36,51.4,"MF"
"Mathieu Bodmer","2018-2019",50,7,4,57.1,3,42.9,15,11,3,11,1,3,10,30,7,3,0,3,2,17,10,0,40,44,47.6,"MF,FW"
"Marvin Martin","2018-2019",30,8,4,50,4,50,2,1,0,2,0,0,6,0,6,2,1,1,2,4,1,0,2,14,12.5,"MF"
"Fodé Ballo-Touré","2018-2019",145,82,48,58.5,34,41.5,93,66,52,35,6,41,72,56.9,31,45,9,36,55,148,80,4,58,50,53.7,"DF"
"Sada Thioub","2018-2019",225,116,72,62.1,44,37.9,30,19,13,10,7,20,45,44.4,25,29,1,28,16,46,11,0,18,36,33.3,"MF,FW"
"Pierre Lees-Melou","2018-2019",81,30,15,50,15,50,74,46,31,36,7,25,62,40.3,37,44,8,36,36,110,37,0,15,22,40.5,"MF"
"Dimitri Liénard","2018-2019",68,25,16,64,9,36,33,18,20,9,4,21,45,46.7,24,11,2,9,18,51,22,0,4,12,25,"MF,DF"
"Saman Ghoddos","2018-2019",124,30,10,33.3,20,66.7,33,17,14,15,4,13,32,40.6,19,15,2,13,7,40,13,0,15,25,37.5,"FW,MF"
"Jimmy Briand","2018-2019",155,28,13,46.4,15,53.6,14,8,2,10,2,4,24,16.7,20,14,6,8,4,18,29,0,49,96,33.8,"FW"
"Vincent Pajot","2018-2019",17,3,1,33.3,2,66.7,18,14,6,8,4,4,14,28.6,10,9,0,9,8,26,6,0,28,19,59.6,"MF"
"Luiz Araújo","2018-2019",45,38,23,60.5,15,39.5,23,17,8,9,6,9,24,37.5,15,6,1,5,3,26,4,0,1,11,8.3,"FW,MF"
"Youssouf Sabaly","2018-2019",109,45,20,44.4,25,55.6,46,32,32,12,2,25,46,54.3,21,19,2,17,26,72,42,0,18,30,37.5,"DF"
"Moussa Konaté","2018-2019",133,24,15,62.5,9,37.5,10,8,3,3,4,2,12,16.7,10,14,3,11,5,15,15,0,51,85,37.5,"FW"
"Dante","2018-2019",2,5,4,80,1,20,54,40,36,16,2,24,41,58.5,17,56,30,26,38,92,156,2,75,41,64.7,"DF"
"Leo Dubois","2018-2019",157,29,13,44.8,16,55.2,51,22,25,21,5,20,35,57.1,15,30,10,20,22,73,61,1,28,24,53.8,"DF"
"Moussa Niakhate","2017-2018",15,21,17,81,4,19,57,38,44,12,1,22,37,59.5,15,27,14,13,55,112,139,1,63,47,57.3,"DF"
"Yassine El Ghanassy","2017-2018",62,52,38,73.1,14,26.9,7,4,1,3,3,1,4,25,3,1,0,1,4,11,4,0,4,6,40,"MF,FW"
"Christophe Kerbrat","2017-2018",1,4,4,100,0,0,62,45,47,14,1,35,65,53.8,30,49,40,9,62,124,249,2,35,54,39.3,"DF"
"Enzo Crivelli","2017-2018",102,18,10,55.6,8,44.4,17,11,4,7,6,2,10,20,8,5,0,5,4,21,8,0,81,99,45,"FW"
"Billy Ketkeophomphone","2017-2018",31,14,9,64.3,5,35.7,14,9,4,5,5,5,15,33.3,10,9,0,9,5,19,8,0,6,14,30,"MF"
"Abdoul Camara","2017-2018",69,34,16,47.1,18,52.9,6,4,2,3,1,3,11,27.3,8,7,1,6,7,13,4,0,9,9,50,"FW,MF"
"Papy Djilobodji","2017-2018",3,18,14,77.8,4,22.2,45,29,34,11,0,21,43,48.8,22,38,25,13,71,116,211,5,87,30,74.4,"DF"
"Ivan Santini","2017-2018",203,18,13,72.2,5,27.8,19,12,5,8,6,4,29,13.8,25,13,5,8,4,23,33,0,111,164,40.4,"FW"
"Rémi Walter","2017-2018",18,31,23,74.2,8,25.8,34,17,13,19,2,5,30,16.7,25,9,4,5,16,50,17,0,16,39,29.1,"MF,FW"
"Romain Hamouma","2017-2018",176,40,19,47.5,21,52.5,19,13,7,6,6,1,22,4.5,21,15,4,11,13,32,8,1,18,32,36,"FW"
"Jordan Marié","2017-2018",34,15,8,53.3,7,46.7,63,38,22,36,5,18,66,27.3,48,26,9,17,40,103,25,2,13,24,35.1,"MF"
"Vukašin Jovanović","2017-2018",1,3,2,66.7,1,33.3,18,14,11,7,0,6,14,42.9,8,18,10,8,27,45,67,0,20,20,50,"DF"
"Rolando","2017-2018",2,4,4,100,0,0,44,29,28,15,1,23,40,57.5,17,22,14,8,37,81,126,0,52,37,58.4,"DF"
"Lucas Lima","2017-2018",121,51,24,47.1,27,52.9,73,46,40,27,6,31,68,45.6,37,42,6,36,38,111,85,0,41,43,48.8,"DF,FW"
"Giovanni Sio","2017-2018",222,43,21,48.8,22,51.2,14,8,2,9,3,0,20,0,20,11,0,11,6,20,23,1,80,67,54.4,"FW"
"Romain Genevois","2017-2018",29,3,3,100,0,0,48,28,27,13,8,21,39,53.8,18,25,11,14,31,79,76,0,45,31,59.2,"DF"
"Ismaël Diomandé","2017-2018",0,2,2,100,0,0,14,8,7,6,1,10,15,66.7,5,11,5,6,5,19,20,0,7,7,50,"DF,MF"
"Jean Seri","2017-2018",53,52,37,71.2,15,28.8,25,14,9,12,4,9,56,16.1,47,16,4,12,26,51,15,4,12,15,44.4,"MF"
"Yaya Sanogo","2017-2018",96,27,14,51.9,13,48.1,11,6,1,5,5,3,11,27.3,8,6,1,5,6,17,14,1,82,80,50.6,"FW"
"Danijel Milićević","2017-2018",69,6,2,33.3,4,66.7,8,4,0,4,4,1,9,11.1,8,5,0,5,3,11,2,0,7,13,35,"MF,FW"
"Jorge","2017-2018",115,52,21,40.4,31,59.6,69,40,34,25,10,23,38,60.5,15,19,2,17,66,135,86,0,30,39,43.5,"DF"
"Marco Verratti","2017-2018",48,51,42,82.4,9,17.6,51,33,20,25,6,12,55,21.8,43,25,6,19,26,77,11,3,7,7,50,"MF"
"Rémy Cabella","2017-2018",195,100,66,66,34,34,65,43,31,24,10,19,77,24.7,58,31,0,31,15,80,4,2,9,25,26.5,"FW,MF"
"Franck Tabanou","2017-2018",41,17,9,52.9,8,47.1,23,17,17,5,1,10,26,38.5,16,5,3,2,26,49,48,0,21,19,52.5,"DF"
"Racine Coly","2017-2018",34,17,14,82.4,3,17.6,15,12,9,5,1,9,19,47.4,10,5,2,3,15,30,18,0,11,6,64.7,"DF"
"Khaled Adénon","2017-2018",1,7,4,57.1,3,42.9,38,24,26,12,0,15,32,46.9,17,42,26,16,65,103,221,1,64,46,58.2,"DF"
"Félix Eboa Eboa","2017-2018",10,12,11,91.7,1,8.3,19,11,12,7,0,8,16,50,8,21,11,10,39,58,119,2,63,32,66.3,"DF"
"Ndombe Mubele","2017-2018",146,83,41,49.4,42,50.6,22,12,11,8,3,9,23,39.1,14,20,0,20,12,34,7,0,10,20,33.3,"FW,MF"
"Idriss Saadi","2017-2018",65,21,7,33.3,13,61.9,6,5,2,3,1,2,11,18.2,9,3,2,1,5,11,1,0,9,25,26.5,"FW"
"Ángel Di María","2017-2018",287,86,48,55.8,38,44.2,13,10,5,3,5,7,39,17.9,32,18,2,16,10,23,8,0,0,2,0,"FW"
"Bouna Sarr","2017-2018",107,71,44,62,27,38,65,42,42,20,3,22,38,57.9,16,20,4,16,32,97,53,2,37,33,52.9,"DF,FW"
"Julian Draxler","2017-2018",117,62,45,72.6,17,27.4,20,14,4,13,3,6,32,18.8,26,18,2,16,28,48,8,0,10,9,52.6,"MF,FW"
"Adama Niane","2017-2018",133,30,13,43.3,17,56.7,22,12,5,10,7,6,26,23.1,20,11,2,9,9,31,13,0,74,189,28.1,"FW"
"Pablo Martinez","2017-2018",24,10,5,50,5,50,41,34,28,12,1,22,49,44.9,27,25,12,13,51,92,112,3,54,37,59.3,"DF"
"Cédric Yamberé","2017-2018",5,23,18,78.3,5,21.7,58,42,46,12,0,16,34,47.1,18,24,16,8,54,112,138,5,65,49,57,"DF"
"Benjamin Nivet","2017-2018",70,19,12,63.2,7,36.8,31,14,12,14,5,11,51,21.6,40,18,1,17,16,47,20,0,16,24,40,"MF,FW"
"Damien Da Silva","2017-2018",2,9,9,100,0,0,52,35,40,12,0,20,33,60.6,13,45,25,20,36,88,184,2,73,60,54.9,"DF"
"Bakary Koné","2017-2018",1,7,6,85.7,1,14.3,26,17,23,3,0,12,31,38.7,19,20,10,10,33,59,122,2,49,32,60.5,"DF"
"Ronny Rodelin","2017-2018",251,74,57,77,17,23,33,22,7,18,8,8,42,19,34,21,2,19,28,61,41,1,140,90,60.9,"FW,MF"
"Maxime Lopez","2017-2018",51,23,16,69.6,7,30.4,30,20,12,12,6,12,56,21.4,44,16,2,14,7,37,6,1,2,11,15.4,"MF,FW"
"Julien Ielsch","2017-2018",13,6,5,83.3,1,16.7,28,18,12,11,5,7,25,28,18,16,3,13,11,39,15,2,3,9,25,"MF,DF"
"Benjamin Bourigeaud","2017-2018",195,48,23,47.9,25,52.1,55,30,18,30,7,20,93,21.5,73,48,4,44,45,100,29,0,12,52,18.8,"MF,FW"
"François Bellugou","2017-2018",13,17,11,64.7,6,35.3,48,33,23,21,4,21,49,42.9,28,20,6,14,28,76,45,0,49,52,48.5,"MF"
"Jordan Amavi","2017-2018",83,71,44,62,27,38,52,35,32,12,8,23,56,41.1,33,28,11,17,45,97,86,1,42,21,66.7,"DF"
"Otávio","2017-2018",2,17,16,94.1,1,5.9,64,42,25,37,2,20,61,32.8,41,26,4,22,32,96,35,0,15,16,48.4,"MF"
"Bakaye Dibassy","2017-2018",48,41,37,90.2,4,9.8,71,51,45,22,4,24,50,48,26,52,26,26,58,129,148,0,39,54,41.9,"DF"
"Junior Sambia","2017-2018",131,49,29,59.2,20,40.8,21,12,6,11,4,6,28,21.4,22,16,0,16,20,41,18,0,27,26,50.9,"MF"
"Paul Baysse","2017-2018",1,2,2,100,0,0,4,2,3,1,0,1,5,20,4,4,3,1,7,11,38,1,24,13,64.9,"DF"
"Julian Palmieri","2017-2018",41,22,12,54.5,10,45.5,29,15,17,9,3,17,29,58.6,12,16,2,14,22,51,31,0,11,10,52.4,"DF"
"Wahbi Khazri","2017-2018",146,71,45,63.4,26,36.6,26,18,7,10,9,7,39,17.9,32,29,0,29,7,33,7,0,15,30,33.3,"FW,MF"
"Romain Thomas","2017-2018",5,2,2,100,0,0,31,21,16,15,0,14,29,48.3,15,32,19,13,34,65,151,1,74,45,62.2,"DF"
"Pedro Rebocho","2017-2018",76,23,16,69.6,7,30.4,29,22,18,8,3,12,28,42.9,16,20,6,14,19,48,76,0,15,19,44.1,"DF"
"Pablo","2017-2018",0,5,4,80,1,20,16,15,13,3,0,10,16,62.5,6,13,7,6,16,32,96,1,41,19,68.3,"DF"
"Allan Saint-Maximin","2017-2018",273,167,108,64.7,59,35.3,18,14,13,2,3,12,28,42.9,16,12,1,11,11,29,10,0,10,17,37,"FW,MF"
"Florian Thauvin","2017-2018",325,171,119,69.6,52,30.4,44,28,16,20,8,15,46,32.6,31,22,1,21,17,61,20,0,15,31,32.6,"FW"
"Emmanuel Rivière","2017-2018",180,22,13,59.1,9,40.9,10,3,1,6,3,1,12,8.3,11,8,0,8,2,12,5,0,101,169,37.4,"FW"
"Naïm Sliti","2017-2018",168,130,104,80,26,20,47,32,20,17,10,20,52,38.5,32,22,2,20,13,60,7,0,14,37,27.5,"FW,MF"
"Benjamin Jeannot","2017-2018",81,13,8,61.5,5,38.5,12,7,5,6,1,1,13,7.7,12,9,3,6,6,18,26,0,48,79,37.8,"FW"
"Aymen Abdennour","2017-2018",0,1,1,100,0,0,7,3,5,2,0,4,7,57.1,3,5,5,0,4,11,20,0,7,7,50,"DF"
"Stef Peeters","2017-2018",43,11,7,63.6,4,36.4,22,11,6,14,2,6,31,19.4,25,17,3,14,7,29,11,0,7,7,50,"MF"
"Marcus Coco","2017-2018",156,47,24,51.1,23,48.9,40,28,17,13,10,7,35,20,28,22,3,19,15,55,9,0,33,42,44,"FW,MF"
"Nicolas Benezet","2017-2018",174,72,45,62.5,27,37.5,38,30,18,16,4,11,37,29.7,26,8,2,6,12,50,7,0,18,34,34.6,"FW,MF"
"Kouadio-Yves Dabila","2017-2018",8,3,3,100,0,0,20,11,14,4,2,6,10,60,4,14,6,8,10,30,46,0,15,15,50,"DF"
"Nolan Roux","2017-2018",216,38,21,55.3,17,44.7,24,17,8,10,6,7,38,18.4,31,32,2,30,25,49,22,0,67,91,42.4,"FW,MF"
"Gerónimo Poblete","2017-2018",20,21,16,76.2,5,23.8,58,37,23,29,6,25,66,37.9,41,19,0,19,24,82,22,1,11,24,31.4,"MF"
"Guy Ngosso","2017-2018",11,6,4,66.7,2,33.3,8,5,4,4,0,4,20,20,16,5,3,2,9,17,19,0,9,10,47.4,"MF"
"Stéphane Sessègnon","2017-2018",43,26,18,69.2,8,30.8,4,4,2,2,0,1,7,14.3,6,0,0,0,0,4,2,0,6,9,40,"MF,FW"
"Christophe Hérelle","2017-2018",4,5,1,20,4,80,39,26,27,12,0,16,30,53.3,14,38,27,11,56,95,241,1,80,40,66.7,"DF"
"Jordan Ferri","2017-2018",30,13,12,92.3,1,7.7,20,11,8,11,1,7,20,35,13,11,1,10,5,25,11,2,6,6,50,"MF"
"Edgar Ié","2017-2018",53,30,24,80,6,20,74,42,55,18,1,31,69,44.9,38,57,26,31,84,158,135,3,81,53,60.4,"DF"
"Ramy Bensebaini","2017-2018",77,34,23,67.6,11,32.4,56,39,31,21,4,26,55,47.3,29,24,16,8,37,93,177,1,71,29,71,"DF"
"Harrison Manzala","2017-2018",137,65,40,61.5,25,38.5,32,23,16,9,7,8,25,32,17,22,3,19,18,50,15,0,11,23,32.4,"FW,MF"
"Yoann Gourcuff","2017-2018",24,6,4,66.7,2,33.3,7,5,1,3,3,0,2,0,2,5,0,5,2,9,2,0,3,7,30,"MF,FW"
"Andrei Girotto","2017-2018",17,15,9,60,6,40,57,38,15,37,5,21,52,40.4,31,32,7,25,15,72,45,1,39,28,58.2,"MF"
"Ferland Mendy","2017-2018",138,70,48,68.6,22,31.4,45,28,29,13,3,20,31,64.5,11,18,5,13,25,70,43,0,37,25,59.7,"DF"
"Ruben Aguilar","2017-2018",160,48,30,62.5,18,37.5,91,50,37,41,13,36,71,50.7,35,25,3,22,37,128,90,0,28,35,44.4,"DF"
"Wylan Cyprien","2017-2018",9,7,5,71.4,2,28.6,9,7,4,4,1,2,11,18.2,9,7,1,6,11,20,7,2,9,3,75,"MF"
"Lebo Mothiba","2017-2018",104,7,5,71.4,2,28.6,8,5,4,0,4,0,7,0,7,6,2,4,2,10,11,0,20,37,35.1,"FW"
"Daniel Congré","2017-2018",14,4,3,75,1,25,62,46,36,24,2,31,59,52.5,28,29,16,13,56,118,124,2,70,39,64.2,"DF"
"Layvin Kurzawa","2017-2018",152,30,18,60,12,40,44,32,20,15,9,15,39,38.5,24,16,3,13,35,79,41,2,33,26,55.9,"DF"
"Jonathan Ikone","2017-2018",85,52,33,63.5,19,36.5,13,10,3,6,4,4,14,28.6,10,8,0,8,6,19,3,0,6,18,25,"MF,FW"
"Kylian Mbappé","2017-2018",294,142,82,57.7,60,42.3,12,9,3,4,5,1,13,7.7,12,4,1,3,1,13,1,0,6,12,33.3,"FW,MF"
"Malang Sarr","2017-2018",17,8,7,87.5,1,12.5,24,18,17,7,0,8,18,44.4,10,14,6,8,31,55,44,2,28,16,63.6,"DF"
"Alexander Djiku","2017-2018",3,7,6,85.7,1,14.3,65,43,52,11,2,25,52,48.1,27,34,5,29,57,122,155,2,81,48,62.8,"DF"
"Oswaldo Vizcarrondo","2017-2018",1,1,1,100,0,0,21,15,17,3,1,14,37,37.8,23,18,16,2,20,41,129,2,50,25,66.7,"DF"
"Lucas Deaux","2017-2018",66,26,18,69.2,8,30.8,62,45,21,37,4,20,67,29.9,47,41,6,35,32,94,19,0,55,43,56.1,"MF"
"Santy Ngom","2017-2018",51,9,6,66.7,3,33.3,10,5,5,5,0,1,8,12.5,7,9,1,8,2,12,2,0,14,19,42.4,"FW,MF"
"Mateo Pavlović","2017-2018",2,4,4,100,0,0,13,7,10,3,0,7,20,35,13,14,11,3,21,34,120,0,68,30,69.4,"DF"
"Jonas Martin","2017-2018",98,41,27,65.9,14,34.1,73,50,41,28,4,17,54,31.5,37,30,3,27,33,106,36,0,46,64,41.8,"MF"
"Christophe Jallet","2017-2018",91,6,5,83.3,1,16.7,29,21,21,8,0,11,26,42.3,15,18,6,12,16,45,47,0,20,14,58.8,"DF"
"Ibrahima Niane","2017-2018",73,37,17,45.9,20,54.1,6,5,4,1,1,2,8,25,6,6,0,6,4,10,8,0,28,36,43.8,"FW,MF"
"Jean-Eudes Aholou","2017-2018",22,50,39,78,11,22,70,34,32,37,1,17,55,30.9,38,29,7,22,75,145,58,1,48,47,50.5,"MF"
"Gabriel Silva","2017-2018",104,28,18,64.3,10,35.7,28,20,19,4,5,19,31,61.3,12,21,6,15,37,65,83,1,27,29,48.2,"DF"
"Kévin Monnet-Paquet","2017-2018",179,40,20,50,20,50,33,25,9,19,5,11,48,22.9,37,15,2,13,13,46,23,1,34,70,32.7,"FW,MF"
"Angelo Fulgini","2017-2018",116,40,26,65,14,35,21,11,9,8,4,8,27,29.6,19,21,2,19,20,41,7,0,9,34,20.9,"MF"
"Lois Diony","2017-2018",81,13,8,61.5,5,38.5,3,0,1,2,0,0,3,0,3,5,1,4,1,4,8,0,12,31,27.9,"FW"
"Djibril Sidibé","2017-2018",170,51,21,41.2,30,58.8,59,39,24,27,8,23,45,51.1,22,20,4,16,46,105,52,1,41,21,66.1,"DF"
"Jérémy Gélin","2017-2018",7,5,3,60,2,40,37,18,22,14,1,20,53,37.7,33,22,12,10,37,74,92,3,40,32,55.6,"DF,MF"
"Jules Koundé","2017-2018",1,8,4,50,4,50,26,19,19,7,0,13,17,76.5,4,14,11,3,14,40,97,0,30,34,46.9,"DF"
"Ole Selnæs","2017-2018",14,8,8,100,0,0,73,45,29,42,2,18,61,29.5,43,37,15,22,34,107,53,1,30,20,60,"MF"
"Arnaud Souquet","2017-2018",123,34,22,64.7,12,35.3,89,68,58,26,5,36,56,64.3,20,46,16,30,39,128,72,2,20,26,43.5,"DF"
"Florent Balmont","2017-2018",21,14,8,57.1,6,42.9,14,9,4,9,1,4,25,16,21,15,1,14,8,22,5,0,0,2,0,"MF"
"Renaud Cohade","2017-2018",140,55,30,54.5,25,45.5,143,86,63,71,9,46,119,38.7,73,70,10,60,53,196,91,0,87,96,47.5,"MF"
"Stéphane Bahoken","2017-2018",124,19,7,36.8,12,63.2,16,11,3,8,5,4,22,18.2,18,18,1,17,9,25,1,0,28,54,34.1,"FW"
"Martin Terrier","2017-2018",107,38,19,50,19,50,42,30,16,23,3,9,28,32.1,19,11,1,10,14,56,6,0,48,52,48,"FW,MF"
"Jaroslav Plašil","2017-2018",21,9,8,88.9,1,11.1,24,14,7,17,0,7,31,22.6,24,18,6,12,21,45,15,0,7,10,41.2,"MF"
"Sanjin Prcić","2017-2018",17,4,2,50,2,50,37,18,9,24,4,8,39,20.5,31,19,5,14,30,67,25,0,11,11,50,"MF"
"Edinson Cavani","2017-2018",168,26,15,57.7,11,42.3,15,9,5,4,6,2,16,12.5,14,10,1,9,5,20,22,0,8,9,47.1,"FW"
"Jérémy Grimm","2017-2018",14,6,6,100,0,0,23,17,15,6,2,9,24,37.5,15,11,3,8,19,42,31,1,27,8,77.1,"MF"
"Alois Confais","2017-2018",12,1,1,100,0,0,8,6,7,1,0,3,9,33.3,6,7,4,3,4,12,15,1,8,10,44.4,"MF,DF"
"Paul Lasne","2017-2018",89,38,27,71.1,11,28.9,68,45,27,39,2,12,54,22.2,42,20,1,19,57,125,26,0,55,48,53.4,"MF"
"Diafra Sakho","2017-2018",43,12,5,41.7,7,58.3,5,4,1,2,2,0,7,0,7,4,0,4,2,7,11,0,21,47,30.9,"FW"
"Nicolas Pépé","2017-2018",285,118,73,61.9,45,38.1,30,18,14,11,5,11,42,26.2,31,23,0,23,10,40,20,0,27,53,33.8,"FW,MF"
"Thiago Motta","2017-2018",9,5,5,100,0,0,28,21,14,11,3,8,24,33.3,16,15,6,9,21,49,26,1,23,28,45.1,"MF"
"Dimitri Payet","2017-2018",203,57,45,78.9,12,21.1,22,11,5,13,4,8,37,21.6,29,19,2,17,19,41,7,1,6,18,25,"MF,FW"
"Léo Lacroix","2017-2018",1,3,3,100,0,0,13,8,8,5,0,5,9,55.6,4,6,3,3,11,24,54,1,20,13,60.6,"DF"
"Gaël Kakuta","2017-2018",194,142,89,62.7,53,37.3,54,32,14,27,13,9,40,22.5,31,33,3,30,26,80,19,0,45,103,30.4,"MF,FW"
"Mariano","2017-2018",127,54,29,53.7,25,46.3,16,11,0,5,11,2,23,8.7,21,9,1,8,3,19,20,0,43,72,37.4,"FW"
"Tanguy Ndombele","2017-2018",63,123,94,76.4,29,23.6,68,44,25,35,8,12,44,27.3,32,57,8,49,41,109,12,0,20,10,66.7,"MF"
"Quentin Cornette","2017-2018",20,20,11,55,9,45,11,8,5,3,3,3,13,23.1,10,7,0,7,3,14,5,0,1,5,16.7,"FW,MF"
"Frederic Guilbert","2017-2018",144,39,23,59,16,41,136,89,71,58,7,50,105,47.6,55,43,13,30,88,224,136,0,97,66,59.5,"DF"
"Baptiste Santamaria","2017-2018",15,25,22,88,3,12,59,40,25,29,5,23,83,27.7,60,39,8,31,43,102,48,2,43,34,55.8,"MF"
"Vincent Bessat","2017-2018",129,19,10,52.6,9,47.4,41,27,23,16,2,22,48,45.8,26,19,1,18,18,59,18,0,5,26,16.1,"DF,MF"
"Ludovic Blas","2017-2018",59,57,41,71.9,16,28.1,23,14,10,12,1,7,36,19.4,29,15,3,12,19,42,9,1,19,33,36.5,"MF"
"Mathieu Dossevi","2017-2018",253,141,73,51.8,68,48.2,35,25,15,15,5,7,39,17.9,32,24,3,21,28,63,12,0,11,22,33.3,"FW,MF"
"Ronaël Pierre-Gabriel","2017-2018",25,23,14,60.9,9,39.1,43,31,33,7,3,17,28,60.7,11,11,2,9,9,52,35,0,7,15,31.8,"DF"
"Radamel Falcao","2017-2018",164,35,19,54.3,16,45.7,11,6,0,8,3,2,13,15.4,11,13,3,10,10,21,11,0,37,69,34.9,"FW"
"Pedro Mendes","2017-2018",14,17,13,76.5,4,23.5,62,50,37,19,6,23,41,56.1,18,36,25,11,44,106,152,0,57,41,58.2,"DF"
"Yannick Cahuzac","2017-2018",11,8,3,37.5,5,62.5,39,28,20,19,0,15,26,57.7,11,29,10,19,30,69,42,0,29,28,50.9,"MF"
"Saidy Janko","2017-2018",79,45,32,71.1,13,28.9,43,30,25,14,4,14,24,58.3,10,21,1,20,14,57,50,0,16,17,48.5,"DF"
"Ihsan Sacko","2017-2018",59,20,9,45,11,55,11,9,6,1,4,2,11,18.2,9,3,0,3,7,18,7,0,14,27,34.1,"FW,MF"
"Neymar","2017-2018",226,212,142,67,70,33,20,14,3,11,6,7,40,17.5,33,4,0,4,5,25,2,0,3,5,37.5,"FW"
"Vahid Selimović","2017-2018",3,4,4,100,0,0,20,14,10,9,1,11,14,78.6,3,10,8,2,17,37,58,1,7,14,33.3,"DF"
"Loïc Perrin","2017-2018",9,11,10,90.9,1,9.1,39,26,28,10,1,21,31,67.7,10,35,22,13,36,75,142,1,76,35,68.5,"DF"
"Kévin Théophile-Catherine","2017-2018",4,20,17,85,3,15,36,27,23,13,0,11,24,45.8,13,19,15,4,31,67,113,1,41,29,58.6,"DF"
"Igor Lewczuk","2017-2018",8,4,2,50,2,50,9,7,5,3,1,3,6,50,3,2,2,0,7,16,11,0,3,6,33.3,"DF"
"Jimmy Giraudon","2017-2018",3,5,5,100,0,0,26,16,20,6,0,10,16,62.5,6,30,22,8,31,57,128,2,44,29,60.3,"DF"
"Andre-Frank Zambo Anguissa","2017-2018",37,78,60,76.9,18,23.1,88,65,23,57,8,32,94,34,62,50,7,43,67,155,46,3,68,41,62.4,"MF"
"Mustapha Diallo","2017-2018",20,8,8,100,0,0,48,36,15,29,4,15,33,45.5,18,20,4,16,20,68,29,0,72,63,53.3,"MF"
"François Moubandje","2017-2018",54,31,19,61.3,12,38.7,28,15,20,7,1,10,34,29.4,24,23,7,16,27,55,75,0,44,18,71,"DF"
"Wesley Lautoa","2017-2018",1,4,4,100,0,0,17,13,11,6,0,6,12,50,6,10,4,6,19,36,24,1,12,12,50,"DF,MF"
"Morgan Sanson","2017-2018",195,72,46,63.9,26,36.1,64,40,13,34,17,21,71,29.6,50,30,0,30,25,89,5,1,21,37,36.2,"MF"
"Hernani","2017-2018",22,21,13,61.9,8,38.1,21,13,9,9,3,10,22,45.5,12,15,2,13,6,27,5,0,13,11,54.2,"MF,FW"
"Marcus Thuram","2017-2018",173,80,60,75,20,25,20,15,6,10,4,6,25,24,19,14,0,14,5,25,12,0,61,62,49.6,"FW"
"Timo Stavitski","2017-2018",31,12,8,66.7,4,33.3,4,3,1,1,2,1,16,6.3,15,7,0,7,3,7,1,0,3,10,23.1,"MF,FW"
"Yassine Benzia","2017-2018",137,71,53,74.6,18,25.4,62,41,21,31,10,17,62,27.4,45,31,4,27,28,90,14,0,11,8,57.9,"MF,FW"
"Chidozie Awaziem","2017-2018",5,6,5,83.3,1,16.7,43,30,33,10,0,28,40,70,12,18,11,7,16,59,97,0,31,28,52.5,"DF"
"Lucas Tousart","2017-2018",10,25,19,76,6,24,98,59,41,55,2,38,98,38.8,60,41,16,25,52,150,79,0,73,49,59.8,"MF"
"Opa Nguette","2017-2018",87,73,38,52.1,35,47.9,27,22,11,12,4,5,21,23.8,16,10,0,10,18,45,13,0,19,17,52.8,"FW,MF"
"Stéphane Darbion","2017-2018",146,49,22,44.9,27,55.1,19,14,13,4,2,5,40,12.5,35,21,2,19,20,39,17,0,12,28,30,"FW,MF"
"Kenny Lala","2017-2018",71,107,62,57.9,45,42.1,87,47,53,28,6,21,47,44.7,26,18,10,8,42,129,70,2,17,17,50,"DF"
"Jérémy Sorbon","2017-2018",0,1,1,100,0,0,32,19,24,7,1,10,32,31.3,22,37,24,13,53,85,152,4,38,21,64.4,"DF"
"Nicolas Pallois","2017-2018",4,22,19,86.4,3,13.6,39,28,25,9,5,18,36,50,18,34,19,15,35,74,182,3,35,30,53.8,"DF"
"Kenny Tete","2017-2018",86,25,10,40,15,60,37,25,24,10,3,15,26,57.7,11,20,7,13,29,66,52,0,20,21,48.8,"DF"
"Clinton N'Jie","2017-2018",74,37,25,67.6,12,32.4,10,6,2,5,3,2,9,22.2,7,5,0,5,3,13,0,0,7,23,23.3,"FW"
"Lassana Diarra","2017-2018",7,35,32,91.4,3,8.6,12,4,4,7,1,8,12,66.7,4,3,1,2,6,18,6,0,10,12,45.5,"MF"
"Kwon Chang-hoon","2017-2018",175,49,28,57.1,21,42.9,37,22,10,18,9,11,35,31.4,24,32,1,31,24,61,30,0,13,52,20,"FW,MF"
"Jonathan Delaplace","2017-2018",12,5,2,40,3,60,10,8,1,8,1,3,10,30,7,13,5,8,8,18,8,0,6,12,33.3,"MF"
"Saîf-Eddine Khaoui","2017-2018",103,80,49,61.3,31,38.8,57,25,22,27,8,15,50,30,35,12,2,10,27,84,9,0,9,20,31,"MF,FW"
"Pierrick Capelle","2017-2018",99,45,34,75.6,11,24.4,50,37,29,17,4,16,70,22.9,54,29,0,29,34,84,26,0,34,44,43.6,"MF"
"Hervé Bazile","2017-2018",110,41,19,46.3,22,53.7,21,15,9,7,5,5,15,33.3,10,22,0,22,15,36,8,0,4,10,28.6,"MF,FW"
"Jérémy Toulalan","2017-2018",1,11,9,81.8,2,18.2,43,25,35,7,1,17,39,43.6,22,25,16,9,28,71,121,0,24,25,49,"DF"
"Jonathan Rivierez","2017-2018",41,40,27,67.5,13,32.5,81,59,50,26,5,41,80,51.3,39,21,7,14,39,120,73,0,21,23,47.7,"DF"
"Adama Soumaoro","2017-2018",0,9,9,100,0,0,9,5,7,2,0,2,3,66.7,1,22,16,6,16,25,50,1,19,9,67.9,"DF"
"Rony Lopes","2017-2018",282,85,46,54.1,39,45.9,55,32,15,27,13,21,78,26.9,57,23,2,21,16,71,22,0,13,48,21.3,"FW,MF"
"Christopher Nkunku","2017-2018",47,19,13,68.4,5,26.3,5,2,2,2,1,3,14,21.4,11,8,2,6,5,10,2,1,4,4,50,"FW,MF"
"Prince-Désir Gouano","2017-2018",0,9,6,66.7,3,33.3,42,29,32,8,2,22,31,71,9,58,47,11,49,91,191,6,92,67,57.9,"DF"
"Jemerson","2017-2018",1,6,4,66.7,2,33.3,48,32,32,15,1,24,31,77.4,7,46,32,14,56,104,169,1,61,52,54,"DF"
"Gaëtan Laborde","2017-2018",72,31,15,48.4,16,51.6,9,7,1,6,2,2,7,28.6,5,8,2,6,1,10,7,1,47,64,42.3,"FW"
"James Lea Siliki","2017-2018",66,51,29,56.9,22,43.1,31,21,9,19,3,6,41,14.6,35,21,1,20,18,49,14,1,20,20,50,"MF"
"Emmanuel Bourgaud","2017-2018",22,11,10,90.9,1,9.1,17,11,5,9,3,10,23,43.5,13,5,0,5,6,23,11,0,12,14,46.2,"FW,MF"
"Jérémy Cordoval","2017-2018",20,12,8,66.7,4,33.3,20,16,12,7,1,9,14,64.3,5,12,2,10,9,29,35,0,4,11,26.7,"DF"
"Corentin Jean","2017-2018",150,34,22,64.7,12,35.3,12,8,4,7,1,5,21,23.8,16,14,1,13,14,26,10,0,15,32,31.9,"FW,MF"
"Florent Mollet","2017-2018",97,37,21,56.8,16,43.2,25,18,10,12,3,3,25,12,22,8,1,7,11,36,8,0,5,19,20.8,"MF,FW"
"Steeve Yago","2017-2018",28,16,7,43.8,9,56.3,49,36,28,17,4,20,37,54.1,17,16,7,9,34,83,64,1,16,12,57.1,"DF"
"Abdoulaye Bamba","2017-2018",55,15,9,60,6,40,29,22,23,6,0,16,30,53.3,14,8,1,7,11,40,52,0,17,13,56.7,"DF"
"Suk Hyun-jun","2017-2018",84,26,7,26.9,19,73.1,6,5,2,2,2,1,9,11.1,8,10,0,10,1,7,7,0,75,68,52.4,"FW"
"Yeni Ngbakoto","2017-2018",43,11,3,27.3,8,72.7,11,10,4,6,1,3,10,30,7,10,0,10,9,20,6,0,6,13,31.6,"FW,MF"
"François Kamano","2017-2018",213,94,46,48.9,48,51.1,32,24,11,14,7,10,35,28.6,25,18,2,16,15,47,8,0,12,24,33.3,"FW"
"Neven Subotić","2017-2018",4,5,2,40,3,60,23,14,16,7,0,10,27,37,17,13,9,4,18,41,96,1,45,22,67.2,"DF"
"Luiz Gustavo","2017-2018",21,44,38,86.4,6,13.6,89,54,45,40,4,26,62,41.9,36,44,13,31,50,139,56,1,39,20,66.1,"MF,DF"
"Durel Avounou","2017-2018",23,6,5,83.3,1,16.7,16,11,6,9,1,5,17,29.4,12,12,1,11,10,26,25,0,5,8,38.5,"DF,MF"
"Bassem Srarfi","2017-2018",77,49,25,51,24,49,17,11,6,9,2,4,14,28.6,10,12,0,12,7,24,6,1,6,11,35.3,"FW,MF"
"Thomas Monconduit","2017-2018",34,52,37,71.2,15,28.8,81,49,33,43,5,34,87,39.1,53,52,17,35,55,136,81,2,50,31,61.7,"MF"
"Cafú","2017-2018",17,13,5,38.5,8,61.5,9,7,3,4,2,3,11,27.3,8,3,1,2,12,21,13,0,18,25,41.9,"MF"
"Lassana Coulibaly","2017-2018",46,29,15,51.7,14,48.3,26,17,13,10,3,10,35,28.6,25,15,1,14,8,34,10,0,10,10,50,"MF"
"Thiago Silva","2017-2018",1,1,1,100,0,0,31,23,19,12,0,12,21,57.1,9,28,18,10,18,49,114,0,47,21,69.1,"DF"
"Yoann Andreu","2017-2018",74,24,13,54.2,11,45.8,48,30,40,6,2,16,39,41,23,23,5,18,37,85,75,1,31,23,57.4,"DF"
"Patrick Burner","2017-2018",30,34,27,79.4,7,20.6,18,12,13,5,0,7,20,35,13,6,0,6,13,31,23,0,9,9,50,"DF"
"Adrien Rabiot","2017-2018",60,51,39,76.5,12,23.5,59,36,27,23,9,15,36,41.7,21,29,10,19,33,92,22,1,32,18,64,"MF"
"Frédéric Sammaritano","2017-2018",109,25,16,64,9,36,29,25,17,9,3,10,36,27.8,26,14,0,14,5,34,15,0,3,23,11.5,"FW,MF"
"Lacina Traoré","2017-2018",65,14,7,50,7,50,9,9,2,3,4,3,7,42.9,4,6,3,3,2,11,21,0,70,48,59.3,"FW"
"Bryan Pelé","2017-2018",142,47,27,57.4,20,42.6,20,9,9,8,3,4,28,14.3,24,11,0,11,15,35,13,0,12,37,24.5,"FW,MF"
"Cheikh M'Bengue","2017-2018",8,2,1,50,1,50,8,4,8,0,0,4,4,100,0,6,4,2,8,16,22,1,9,2,81.8,"DF"
"Clément Grenier","2017-2018",69,30,22,73.3,8,26.7,24,15,4,13,7,12,42,28.6,30,16,1,15,14,38,15,1,16,21,43.2,"MF"
"Cédric Varrault","2017-2018",1,3,3,100,0,0,13,7,6,7,0,9,12,75,3,14,11,3,16,29,72,0,21,10,67.7,"DF"
"Jonathan Cafu","2017-2018",75,26,13,50,13,50,16,9,7,6,3,5,13,38.5,8,6,1,5,10,26,1,0,5,10,33.3,"FW,MF"
"Adrien Tameze","2017-2018",23,46,36,78.3,10,21.7,58,36,32,21,5,26,47,55.3,21,26,5,21,41,99,22,1,21,20,51.2,"MF"
"Adil Rami","2017-2018",3,8,7,87.5,1,12.5,39,29,22,15,2,22,41,53.7,19,25,19,6,45,84,163,3,92,46,66.7,"DF"
"Chris Philipps","2017-2018",14,4,2,50,2,50,22,12,10,10,2,5,26,19.2,21,13,5,8,30,52,18,0,7,12,36.8,"MF,DF"
"Préjuce Nakoulma","2017-2018",99,45,18,40,27,60,10,8,3,6,1,2,7,28.6,5,2,0,2,5,15,0,0,17,42,28.8,"FW"
"Nicolas Cozza","2017-2018",24,16,7,43.8,9,56.3,21,11,12,8,1,7,16,43.8,9,5,2,3,13,34,12,0,4,12,25,"DF,MF"
"Memphis","2017-2018",266,108,58,53.7,50,46.3,13,9,4,3,6,3,28,10.7,25,15,0,15,9,22,5,0,8,26,23.5,"FW"
"Guido Carrillo","2017-2018",14,1,1,100,0,0,3,1,0,2,1,0,4,0,4,3,1,2,0,3,8,0,30,23,56.6,"FW"
"Mario Balotelli","2017-2018",173,48,30,62.5,18,37.5,7,4,1,3,3,0,6,0,6,9,2,7,8,15,26,0,31,27,53.4,"FW"
"Jordan Ikoko","2017-2018",105,41,24,58.5,17,41.5,44,29,24,15,5,22,42,52.4,20,20,2,18,48,92,74,0,19,18,51.4,"DF"
"Robert Berić","2017-2018",47,9,3,33.3,6,66.7,6,4,1,3,2,1,16,6.3,15,9,1,8,5,11,4,0,16,35,31.4,"FW"
"Nuno da Costa","2017-2018",134,86,50,58.1,36,41.9,50,32,12,29,9,7,35,20,28,21,0,21,19,69,9,0,42,55,43.3,"FW,MF"
"Wesley Saïd","2017-2018",124,48,32,66.7,16,33.3,33,22,17,11,5,7,26,26.9,19,15,1,14,15,48,4,0,8,15,34.8,"FW,MF"
"Thiago Maia","2017-2018",41,52,41,78.8,11,21.2,55,40,26,26,3,15,61,24.6,46,32,10,22,61,116,47,1,19,22,46.3,"MF,DF"
"Casimir Ninga","2017-2018",100,41,16,39,25,61,12,7,1,6,5,2,10,20,8,12,2,10,4,16,13,0,21,48,30.4,"FW,MF"
"Mathieu Debuchy","2017-2018",88,15,6,40,9,60,34,25,22,8,4,17,30,56.7,13,16,10,6,27,61,73,0,61,28,68.5,"DF"
"Tristan Dingomé","2017-2018",32,9,6,66.7,3,33.3,25,20,12,9,4,5,13,38.5,8,12,0,12,12,37,16,1,7,10,41.2,"MF"
"Baptiste Guillaume","2017-2018",36,4,2,50,2,50,4,1,0,2,2,0,5,0,5,4,1,3,2,6,1,0,24,25,49,"FW,MF"
"Théo Pellenard","2017-2018",48,19,14,73.7,5,26.3,32,20,13,15,4,10,28,35.7,18,15,6,9,32,64,31,0,12,13,48,"DF"
"Rafael","2017-2018",95,44,24,54.5,20,45.5,54,28,30,18,6,22,43,51.2,21,20,3,17,42,96,53,0,27,28,49.1,"DF"
"Vincent Koziello","2017-2018",4,9,6,66.7,3,33.3,16,8,9,5,2,5,16,31.3,11,8,3,5,19,35,7,1,3,13,18.8,"MF"
"Rene Krhin","2017-2018",4,15,12,80,3,20,18,12,7,11,0,3,17,17.6,14,11,2,9,16,34,39,0,41,45,47.7,"MF"
"Fernando Marçal","2017-2018",63,10,2,20,8,80,34,20,22,8,4,14,29,48.3,15,14,6,8,26,60,69,0,28,19,59.6,"DF"
"Valentin Rosier","2017-2018",121,62,48,77.4,14,22.6,73,54,47,23,3,26,68,38.2,42,43,9,34,58,131,124,0,43,38,53.1,"DF"
"Guessouma Fofana","2017-2018",19,16,13,81.3,3,18.8,20,13,8,12,0,6,13,46.2,7,7,1,6,12,32,11,0,14,16,46.7,"MF"
"Oualid El Hajjam","2017-2018",74,32,19,59.4,13,40.6,64,44,37,22,5,23,49,46.9,26,25,5,20,59,123,91,1,17,29,37,"DF"
"Lucas Ocampos","2017-2018",146,82,46,56.1,36,43.9,83,57,30,44,9,30,93,32.3,63,42,3,39,30,113,26,0,39,70,35.8,"FW"
"Flavien Tait","2017-2018",182,101,69,68.3,31,30.7,50,36,26,18,6,18,78,23.1,60,43,4,39,20,70,17,1,2,17,10.5,"MF"
"Issa Cissokho","2017-2018",26,10,8,80,2,20,31,23,22,9,0,18,32,56.3,14,18,8,10,34,65,87,1,16,26,38.1,"DF"
"Yacine Bammou","2017-2018",59,7,2,28.6,5,71.4,18,11,6,10,2,4,14,28.6,10,16,4,12,6,24,9,0,10,20,33.3,"MF,FW"
"Hamari Traoré","2017-2018",90,35,24,68.6,11,31.4,79,55,43,31,5,41,66,62.1,25,31,12,19,61,140,117,0,55,42,56.7,"DF"
"Mehdi Abeid","2017-2018",14,20,14,70,6,30,23,15,8,14,1,8,32,25,24,11,6,5,18,41,25,2,13,16,44.8,"MF"
"Milan Biševac","2017-2018",3,1,1,100,0,0,7,5,5,1,1,5,7,71.4,2,2,0,2,5,12,43,0,4,8,33.3,"DF"
"Benoît Assou-Ekotto","2017-2018",17,9,8,88.9,1,11.1,12,9,5,6,1,5,15,33.3,10,7,4,3,46,58,21,0,3,8,27.3,"DF"
"Romain Danzé","2017-2018",30,4,0,0,4,100,12,7,3,4,5,8,13,61.5,5,11,2,9,3,15,34,0,14,9,60.9,"DF"
"Houssem Aouar","2017-2018",131,113,81,71.7,32,28.3,66,42,22,39,5,20,66,30.3,46,30,0,30,39,105,34,0,22,30,42.3,"MF,FW"
"Jessy Deminguet","2017-2018",47,7,5,71.4,2,28.6,12,9,4,6,2,4,14,28.6,10,5,0,5,10,22,13,0,7,4,63.6,"MF,FW"
"Bongani Zungu","2017-2018",15,21,16,76.2,5,23.8,54,37,21,26,7,24,56,42.9,32,30,5,25,38,92,41,2,30,32,48.4,"MF"
"Baissama Sankoh","2017-2018",19,19,11,57.9,8,42.1,27,19,8,18,1,8,28,28.6,20,20,8,12,25,52,64,1,33,35,48.5,"MF,DF"
"Morgan Amalfitano","2017-2018",34,12,9,75,3,25,8,5,3,3,2,2,5,40,3,6,0,6,4,12,7,0,2,12,14.3,"MF,FW"
"Julien Féret","2017-2018",96,44,27,61.4,17,38.6,40,27,10,25,5,14,75,18.7,61,52,7,45,49,89,58,2,86,61,58.5,"MF"
"Boubakary Soumaré","2017-2018",8,14,13,92.9,1,7.1,13,9,8,5,0,3,14,21.4,11,8,1,7,7,20,6,1,9,2,81.8,"MF"
"Presnel Kimpembe","2017-2018",3,22,19,86.4,3,13.6,39,28,20,18,1,9,14,64.3,5,17,10,7,24,63,80,1,31,23,57.4,"DF"
"Samuel Moutoussamy","2017-2018",16,10,6,60,4,40,15,7,6,7,2,5,8,62.5,3,7,1,6,3,18,4,0,6,3,66.7,"MF"
"Nicolas de Préville","2017-2018",186,113,54,47.8,59,52.2,37,30,10,16,11,10,38,26.3,28,28,4,24,21,58,14,0,32,61,34.4,"FW"
"Jonathan Bamba","2017-2018",247,83,43,51.8,39,47,30,21,18,11,1,12,61,19.7,49,30,4,26,19,49,17,0,24,44,35.3,"FW"
"Diego Carlos","2017-2018",8,5,4,80,1,20,70,42,51,15,4,28,38,73.7,10,50,29,21,29,99,155,3,75,33,69.4,"DF"
"Jonathan Martins Pereira","2017-2018",55,13,9,69.2,4,30.8,34,18,21,10,3,8,23,34.8,15,9,3,6,37,71,39,1,20,7,74.1,"DF"
"Ismaël Traoré","2017-2018",6,19,14,73.7,5,26.3,54,32,40,13,1,14,29,48.3,15,25,10,15,52,106,132,2,41,36,53.2,"DF"
"Lebogang Phiri","2017-2018",4,10,8,80,2,20,28,17,14,12,2,11,43,25.6,32,9,2,7,19,47,13,0,8,5,61.5,"MF"
"Giannelli Imbula","2017-2018",40,84,65,77.4,19,22.6,29,19,10,15,4,7,29,24.1,22,17,2,15,20,49,13,3,17,19,47.2,"MF"
"Maxime Poundjé","2017-2018",69,58,35,60.3,23,39.7,53,29,32,16,5,28,51,54.9,23,14,6,8,35,88,63,1,26,8,76.5,"DF"
"Adama Mbengue","2017-2018",107,47,29,61.7,18,38.3,71,48,48,18,5,41,65,63.1,24,21,1,20,28,99,50,0,18,16,52.9,"DF"
"Issiaga Sylla","2017-2018",87,29,13,44.8,16,55.2,44,32,22,16,6,19,47,40.4,28,31,4,27,34,78,65,1,48,31,60.8,"DF,FW"
"Yannis Salibur","2017-2018",136,78,51,65.4,27,34.6,11,9,4,6,1,4,15,26.7,11,7,1,6,7,18,2,0,10,13,43.5,"FW,MF"
"Alassane Pléa","2017-2018",294,102,68,66.7,34,33.3,15,9,5,7,3,5,32,15.6,27,14,3,11,8,23,21,0,21,55,27.6,"FW"
"Kelvin Amian","2017-2018",83,34,19,55.9,15,44.1,59,43,45,10,4,22,31,71,9,25,7,18,45,104,127,1,36,38,48.6,"DF"
"Ibrahim Sangaré","2017-2018",23,36,29,80.6,7,19.4,72,47,35,34,3,29,69,42,40,33,7,26,24,96,19,1,28,25,52.8,"MF"
"Andrea Raggi","2017-2018",33,4,2,50,2,50,20,10,15,4,1,10,27,37,17,12,6,6,31,51,66,0,13,14,48.1,"DF"
"Maxwel Cornet","2017-2018",143,43,20,46.5,23,53.5,17,12,6,9,2,3,25,12,22,11,1,10,14,31,14,0,13,31,29.5,"FW"
"Nabil Fekir","2017-2018",178,119,90,75.6,29,24.4,45,33,11,24,10,8,40,20,32,11,0,11,8,53,5,0,19,25,43.2,"MF,FW"
"Gilles Sunu","2017-2018",73,18,11,61.1,7,38.9,4,4,1,3,0,0,4,0,4,7,0,7,3,7,3,0,16,22,42.1,"MF,FW"
"Jordan Nkololo","2017-2018",30,7,5,71.4,2,28.6,9,6,4,5,0,1,4,25,3,7,1,6,1,10,0,0,3,11,21.4,"MF,FW"
"Ismaila Sarr","2017-2018",205,105,63,60,41,39,20,10,5,10,5,7,29,24.1,22,17,0,17,9,29,3,1,11,32,25.6,"FW,MF"
"Somália","2017-2018",99,79,38,48.1,41,51.9,65,45,21,36,8,14,54,25.9,40,34,2,32,34,99,35,0,29,53,35.4,"MF,FW"
"Ellyes Skhiri","2017-2018",49,50,41,82,9,18,89,54,34,47,8,37,88,42,51,59,10,49,77,166,57,4,35,34,50.7,"MF"
"Vincent Manceau","2017-2018",104,24,16,66.7,8,33.3,84,49,56,22,6,42,76,55.3,34,34,2,32,34,118,103,0,30,26,53.6,"DF"
"Anthony Gonçalves","2017-2018",139,23,9,39.1,14,60.9,50,31,14,32,4,15,50,30,35,27,0,27,25,75,27,0,24,32,42.9,"MF,FW"
"Johann Obiang","2017-2018",21,6,1,16.7,5,83.3,13,9,9,2,2,6,13,46.2,7,9,1,8,7,20,15,0,5,11,31.3,"DF"
"Yoann Salmier","2017-2018",2,8,7,87.5,1,12.5,15,13,10,5,0,5,12,41.7,7,11,6,5,26,41,62,1,11,10,52.4,"DF"
"Youssef Aït Bennasser","2017-2018",27,51,43,84.3,8,15.7,47,28,17,27,3,15,64,23.4,49,35,2,33,32,79,30,0,23,32,41.8,"MF"
"Bertrand Traoré","2017-2018",270,82,52,63.4,30,36.6,32,20,7,20,5,10,35,28.6,25,24,3,21,39,71,31,1,26,15,63.4,"FW"
"Vitorino Hilton","2017-2018",1,10,8,80,2,20,44,26,33,11,0,13,36,36.1,23,28,14,14,58,102,140,5,68,32,68,"DF"
"Bryan Dabo","2017-2018",49,34,26,76.5,8,23.5,25,16,12,10,3,7,29,24.1,22,12,1,11,11,36,22,0,35,22,61.4,"MF,FW"
"Souleymane Camara","2017-2018",87,11,6,54.5,5,45.5,6,4,0,5,1,0,3,0,3,3,1,2,2,8,15,0,31,40,43.7,"FW"
"Kamil Glik","2017-2018",5,4,3,75,1,25,36,23,22,12,2,15,29,51.7,14,28,18,10,54,90,279,2,89,58,60.5,"DF"
"Younousse Sankharé","2017-2018",43,34,21,61.8,12,35.3,33,23,10,20,3,4,34,11.8,30,15,4,11,21,54,7,0,28,27,50.9,"MF"
"Alexis Blin","2017-2018",28,13,8,61.5,5,38.5,57,37,23,30,4,22,69,31.9,47,27,6,21,31,88,31,0,33,36,47.8,"MF"
"Kostas Mitroglou","2017-2018",41,2,1,50,1,50,3,2,1,2,0,1,4,25,3,1,1,0,0,3,2,0,22,13,62.9,"FW"
"Thiago Mendes","2017-2018",126,48,39,81.3,9,18.8,25,16,10,11,4,5,23,21.7,18,21,3,18,25,50,29,0,21,14,60,"MF"
"Adrien Thomasson","2017-2018",206,35,21,60,14,40,71,52,41,23,7,22,73,30.1,51,58,4,54,18,89,20,0,13,34,27.7,"MF,FW"
"Thomas Mangani","2017-2018",68,36,20,55.6,16,44.4,92,59,35,46,11,28,120,23.3,92,40,5,35,40,132,45,1,33,50,39.8,"MF"
"Mehdi Zeffane","2017-2018",33,7,4,57.1,3,42.9,17,12,10,5,2,9,25,36,16,10,2,8,12,29,44,0,12,13,48,"DF,MF"
"Dani Alves","2017-2018",144,42,28,66.7,14,33.3,80,57,45,27,8,33,58,56.9,25,24,3,21,28,108,21,0,16,19,45.7,"DF"
"Boubacar Kamara","2017-2018",4,6,5,83.3,1,16.7,14,14,9,5,0,8,12,66.7,4,7,3,4,3,17,18,0,10,9,52.6,"DF,MF"
"Keagan Dolly","2017-2018",97,18,12,66.7,6,33.3,12,7,2,7,3,1,11,9.1,10,11,0,11,1,13,2,0,6,12,33.3,"MF,FW"
"Ezequiel Ponce","2017-2018",65,14,12,85.7,2,14.3,9,8,3,5,1,0,7,0,7,2,1,1,3,12,11,0,28,57,32.9,"FW"
"Christian Kouakou","2017-2018",66,16,6,37.5,10,62.5,24,13,14,8,2,5,19,26.3,14,16,1,15,8,32,6,1,9,8,52.9,"MF,FW"
"Mexer","2017-2018",1,1,1,100,0,0,15,12,9,6,0,9,12,75,3,13,7,6,16,31,98,2,42,27,60.9,"DF"
"Iván Balliu","2017-2018",92,27,16,59.3,11,40.7,34,22,22,6,6,12,28,42.9,16,23,9,14,27,61,64,1,25,23,52.1,"DF"
"Serge Gakpé","2017-2018",122,34,19,55.9,15,44.1,16,11,9,7,0,6,27,22.2,21,18,1,17,10,26,15,0,17,38,30.9,"FW,MF"
"Benjamin Corgnet","2017-2018",80,36,25,69.4,11,30.6,28,19,5,16,7,6,28,21.4,22,18,1,17,11,39,11,0,57,54,51.4,"MF,FW"
"Adrien Hunou","2017-2018",124,20,8,40,12,60,27,15,11,8,8,11,42,26.2,31,22,1,21,9,36,8,1,11,31,26.2,"FW,MF"
"Samuel Grandsir","2017-2018",233,134,68,50.7,66,49.3,69,43,39,18,12,21,73,28.8,52,31,3,28,23,92,19,1,12,45,21.1,"FW,MF"
"Étienne Didot","2017-2018",26,10,6,60,4,40,54,33,20,33,1,20,43,46.5,23,21,7,14,19,73,29,0,20,18,52.6,"MF"
"Andy Delort","2017-2018",240,41,19,46.3,22,53.7,20,13,2,9,9,4,19,21.1,15,10,0,10,12,32,22,0,98,100,49.5,"FW"
"Ludovic Baal","2017-2018",35,20,18,90,2,10,41,27,29,8,4,13,35,37.1,22,13,2,11,15,56,37,1,28,14,66.7,"DF"
"Yann M'Vila","2017-2018",4,6,5,83.3,1,16.7,26,16,11,12,3,7,24,29.2,17,13,1,12,31,57,56,0,19,14,57.6,"MF"
"Jeff Reine-Adélaïde","2017-2018",17,30,21,70,9,30,13,8,7,5,1,6,17,35.3,11,7,2,5,1,14,9,0,8,10,44.4,"MF"
"Júlio Tavares","2017-2018",139,14,10,71.4,4,28.6,3,1,1,1,1,1,11,9.1,10,11,6,5,3,6,36,0,164,144,53.2,"FW"
"Marquinhos","2017-2018",6,2,2,100,0,0,28,14,14,14,0,13,21,61.9,8,36,22,14,14,42,114,2,42,20,67.7,"DF"
"Hiroki Sakai","2017-2018",117,36,20,55.6,16,44.4,66,45,30,30,6,32,49,65.3,17,32,7,25,45,111,90,1,61,39,61,"DF"
"Romain Amalfitano","2017-2018",46,71,47,66.2,24,33.8,59,37,18,38,3,25,69,36.2,44,29,7,22,85,144,35,2,13,29,31,"MF"
"Jérémy Blayac","2017-2018",129,13,10,76.9,3,23.1,5,3,0,3,2,2,9,22.2,7,7,2,5,1,6,11,0,93,58,61.6,"FW"
"Kader Mangane","2017-2018",5,8,8,100,0,0,37,24,29,8,0,11,21,52.4,10,28,18,10,24,61,120,4,46,35,56.8,"DF"
"Valentín Vada","2017-2018",43,15,9,60,6,40,22,11,7,14,1,8,32,25,24,8,1,7,6,28,5,1,4,8,33.3,"MF"
"Georges Mandjeck","2017-2018",10,16,10,62.5,6,37.5,25,14,8,16,1,8,18,44.4,10,9,3,6,18,43,21,1,34,21,61.8,"MF,DF"
"Charles Traore","2017-2018",101,36,20,55.6,16,44.4,60,32,46,9,5,26,56,46.4,30,52,16,36,57,117,171,0,40,35,53.3,"DF"
"Ola Toivonen","2017-2018",38,6,5,83.3,1,16.7,4,4,1,0,3,0,7,0,7,2,0,2,2,6,12,0,42,34,55.3,"FW,MF"
"Alexandre Mendy","2017-2018",64,9,6,66.7,3,33.3,4,4,1,2,1,1,6,16.7,5,5,1,4,1,5,4,0,34,50,40.5,"FW"
"Jan Repas","2017-2018",91,22,9,40.9,13,59.1,14,11,5,5,4,4,18,22.2,14,10,0,10,7,21,3,0,8,22,26.7,"MF,FW"
"Thomas Meunier","2017-2018",146,26,19,73.1,7,26.9,38,21,22,12,4,18,34,52.9,16,7,2,5,18,56,54,2,23,11,67.6,"DF"
"Ernest Seka","2017-2018",53,42,22,52.4,20,47.6,60,47,41,14,5,40,61,65.6,21,25,8,17,51,111,98,1,66,31,68,"DF"
"Marcelo","2017-2018",4,5,5,100,0,0,27,25,16,10,1,9,25,36,16,32,18,14,57,84,235,4,141,45,75.8,"DF"
"Kévin N'Doram","2017-2018",2,6,4,66.7,2,33.3,16,10,6,9,1,6,24,25,18,6,2,4,16,32,29,0,18,11,62.1,"MF,DF"
"Faitout Maouassa","2017-2018",78,31,9,29,22,71,6,3,2,3,1,2,10,20,8,12,2,10,6,12,5,0,6,13,31.6,"MF,FW"
"Stiven Mendoza","2017-2018",81,38,26,68.4,12,31.6,18,10,7,7,4,2,11,18.2,9,11,1,10,15,33,8,0,6,18,25,"FW,MF"
"Habib Maïga","2017-2018",19,22,19,86.4,3,13.6,29,18,16,10,3,12,30,40,18,8,4,4,19,48,10,0,7,12,36.8,"MF,DF"
"Jérémy Morel","2017-2018",0,8,5,62.5,3,37.5,39,27,23,15,1,18,23,78.3,5,28,23,5,46,85,129,5,55,33,62.5,"DF"
"Valère Germain","2017-2018",148,9,4,44.4,5,55.6,16,11,5,7,4,3,18,16.7,15,11,0,11,6,22,19,0,50,100,33.3,"FW"
"Danilo Avelar","2017-2018",66,25,11,44,14,56,41,33,27,9,5,14,45,31.1,31,16,7,9,37,78,83,1,48,25,65.8,"DF"
"Karim Azamoum","2017-2018",76,22,13,59.1,9,40.9,84,57,41,37,6,27,68,39.7,41,30,11,19,26,110,61,3,71,59,54.6,"MF"
"Mehdi Tahrat","2017-2018",4,7,6,85.7,1,14.3,7,6,4,3,0,2,5,40,3,3,1,2,9,16,15,1,19,11,63.3,"MF"
"Oussama Haddadi","2017-2018",114,34,25,73.5,9,26.5,44,29,33,9,2,14,47,29.8,33,29,12,17,43,87,79,1,17,28,37.8,"DF"
"Valentin Rongier","2017-2018",100,50,35,70,15,30,73,49,25,39,9,17,64,26.6,47,42,6,36,40,113,13,1,27,31,46.6,"MF"
"Fouad Chafik","2017-2018",79,33,24,72.7,9,27.3,58,49,31,19,8,20,35,57.1,15,17,1,16,33,91,46,1,25,28,47.2,"DF"
"Abdoulaye Touré","2017-2018",34,64,45,70.3,19,29.7,74,52,28,38,8,23,67,34.3,44,40,10,30,62,136,49,1,61,34,64.2,"MF"
"Benjamin André","2017-2018",117,44,35,79.5,9,20.5,93,54,36,50,7,43,113,38.1,70,56,4,52,57,150,96,1,187,151,55.3,"MF"
"Jimmy Durmaz","2017-2018",79,29,18,62.1,11,37.9,16,9,5,5,6,6,14,42.9,8,2,0,2,14,30,9,0,10,8,55.6,"MF,FW"
"Jules Iloki","2017-2018",147,13,9,69.2,4,30.8,13,9,1,9,3,3,16,18.8,13,8,0,8,12,25,16,0,11,9,55,"MF,FW"
"Xeka","2017-2018",42,26,15,57.7,11,42.3,26,14,11,11,4,10,38,26.3,28,14,2,12,17,43,21,0,14,24,36.8,"MF"
"Stevan Jovetić","2017-2018",62,11,6,54.5,5,45.5,4,4,0,3,1,0,9,0,9,5,0,5,3,7,3,0,26,31,45.6,"FW"
"Fodé Ballo-Touré","2017-2018",98,23,16,69.6,7,30.4,50,36,29,16,5,21,47,44.7,26,27,2,25,28,78,47,1,26,30,46.4,"DF"
"Pierre Lees-Melou","2017-2018",193,45,33,73.3,12,26.7,78,47,29,39,10,27,76,35.5,49,52,11,41,34,112,38,2,13,31,29.5,"MF,FW"
"Dimitri Liénard","2017-2018",118,52,34,65.4,18,34.6,77,51,37,32,8,30,84,35.7,54,35,2,33,52,129,41,1,9,21,30,"MF,FW"
"Jimmy Briand","2017-2018",226,43,23,53.5,20,46.5,33,21,13,15,5,4,42,9.5,38,17,2,15,12,45,51,0,63,108,36.8,"FW"
"Vincent Pajot","2017-2018",24,7,4,57.1,3,42.9,24,16,9,13,2,3,17,17.6,14,21,9,12,24,48,34,0,72,48,60,"MF"
"Luiz Araújo","2017-2018",152,106,75,70.8,31,29.2,41,31,23,17,1,10,47,21.3,37,24,0,24,16,57,11,1,5,14,26.3,"FW,MF"
"Youssouf Sabaly","2017-2018",145,79,51,64.6,28,35.4,93,61,54,34,5,43,68,63.2,25,26,6,20,54,147,104,0,40,41,49.4,"DF"
"Facundo Píriz","2017-2018",8,10,6,60,4,40,25,16,9,12,4,6,35,17.1,29,10,1,9,18,43,14,0,20,16,55.6,"MF"
"Moussa Konaté","2017-2018",173,27,12,44.4,15,55.6,8,6,1,4,3,3,23,13,20,10,2,8,3,11,11,0,71,108,39.7,"FW"
"Dante","2017-2018",3,10,8,80,2,20,43,28,32,10,1,21,36,58.3,15,44,25,19,47,90,130,2,62,40,60.8,"DF"
"Martin Braithwaite","2017-2018",56,16,8,50,8,50,6,4,0,4,2,1,6,16.7,5,6,2,4,0,6,3,0,20,27,42.6,"FW"
"Leo Dubois","2017-2018",130,54,38,70.4,16,29.6,50,39,33,15,2,20,47,42.6,27,47,13,34,50,100,99,2,34,35,49.3,"DF"
"Mathieu Deplagne","2017-2018",83,23,15,65.2,8,34.8,52,38,33,14,5,20,48,41.7,28,26,10,16,60,112,95,2,49,39,55.7,"DF"
"Anwar El Ghazi","2017-2018",163,44,24,54.5,20,45.5,23,18,7,13,3,9,29,31,20,11,1,10,7,30,7,1,17,27,38.6,"FW,MF"
"Mikel San José","2020-2021",7,8,4,50,4,50,35,20,22,12,1,18,46,39.1,28,24,10,14,26,61,49,1,43,39,52.4,"MF,DF"
"Morgan Fox","2020-2021",46,11,8,72.7,3,27.3,32,17,15,16,1,12,26,46.2,14,16,7,9,26,58,54,1,49,29,62.8,"DF"
"Samba Sow","2020-2021",5,15,8,53.3,7,46.7,37,26,25,9,3,13,27,48.1,14,19,0,19,24,61,15,0,29,14,67.4,"MF"
"Álex Vallejo","2020-2021",13,7,5,71.4,2,28.6,26,12,16,8,2,10,16,62.5,6,19,7,12,21,47,11,1,15,7,68.2,"MF,DF"
"Kieffer Moore","2020-2021",212,48,33,68.8,15,31.3,18,12,5,11,2,7,13,53.8,6,24,3,21,8,26,52,0,438,292,60,"FW"
"Aapo Halme","2020-2021",1,1,1,100,0,0,14,10,4,10,0,7,14,50,7,9,3,6,13,27,19,0,51,32,61.4,"MF,DF"
"Bright Osayi-Samuel","2020-2021",180,94,58,61.7,36,38.3,23,11,5,13,5,4,10,40,6,7,0,7,11,34,0,0,7,37,15.9,"FW"
"Elijah Adebayo","2020-2021",108,35,14,40,21,60,8,3,3,5,0,2,4,50,2,8,1,7,5,13,16,0,84,121,41,"FW"
"Nick Powell","2020-2021",148,41,16,39,25,61,66,38,17,33,16,16,48,33.3,32,44,6,38,40,106,25,0,135,135,50,"MF,FW"
"Teemu Pukki","2020-2021",292,45,19,42.2,26,57.8,23,9,4,11,8,9,30,30,21,32,6,26,9,32,10,0,9,55,14.1,"FW"
"Alfa Semedo","2020-2021",66,60,41,68.3,19,31.7,66,48,30,28,8,29,69,42,40,39,8,31,29,95,34,2,87,107,44.8,"MF,FW"
"Lewis O'Brien","2020-2021",192,90,56,62.2,34,37.8,85,42,39,34,12,27,77,35.1,50,55,12,43,40,125,52,0,39,46,45.9,"MF"
"Jonny Howson","2020-2021",23,33,19,57.6,14,42.4,81,49,37,40,4,32,60,53.3,28,37,7,30,50,131,77,1,70,66,51.5,"MF"
"Anthony Stewart","2020-2021",6,19,11,57.9,8,42.1,31,14,22,9,0,15,24,62.5,9,37,24,13,39,70,141,1,86,69,55.5,"DF"
"Sean Morrison","2020-2021",16,7,4,57.1,3,42.9,51,29,36,14,1,26,41,63.4,15,33,22,11,55,106,155,1,219,85,72,"DF"
"Jordi Osei-Tutu","2020-2021",9,12,8,66.7,4,33.3,15,9,8,6,1,8,14,57.1,6,4,1,3,10,25,19,0,8,5,61.5,"DF"
"Harry Souttar","2020-2021",2,16,13,81.3,3,18.8,42,28,32,10,0,21,34,61.8,13,44,24,20,52,94,211,2,204,72,73.9,"DF"
"Osman Kakay","2020-2021",86,40,21,52.5,19,47.5,36,22,15,13,8,24,43,55.8,19,25,14,11,22,58,74,0,27,33,45,"DF"
"Ryan Bennett","2020-2021",1,4,4,100,0,0,29,16,20,9,0,15,29,51.7,14,38,25,13,54,83,118,0,100,59,62.9,"DF"
"Jake Clarke-Salter","2020-2021",3,7,5,71.4,2,28.6,20,10,13,7,0,6,10,60,4,8,5,3,14,34,21,1,49,34,59,"DF"
"Mathias Jensen","2020-2021",75,48,28,58.3,20,41.7,53,25,31,17,5,26,106,24.5,80,35,3,32,53,106,27,0,13,26,33.3,"MF"
"Joe Rothwell","2020-2021",56,79,50,63.3,29,36.7,32,18,10,17,5,12,45,26.7,33,20,5,15,23,55,16,0,4,11,26.7,"MF,FW"
"Alex Mighten","2020-2021",84,52,24,46.2,28,53.8,10,8,5,2,3,3,12,25,9,6,1,5,6,16,10,0,5,21,19.2,"FW"
"Pipa","2020-2021",155,92,42,45.7,50,54.3,59,39,40,15,4,32,67,47.8,35,23,4,19,31,90,64,1,31,45,40.8,"DF"
"Osaze Urhoghide","2020-2021",6,7,4,57.1,3,42.9,28,17,20,6,2,14,24,58.3,10,14,6,8,25,53,48,1,48,38,55.8,"DF"
"Dimitris Giannoulis","2020-2021",97,28,16,57.1,12,42.9,34,18,24,8,2,13,25,52,12,19,4,15,17,51,23,1,24,25,49,"DF"
"Sergi Canós","2020-2021",250,109,58,53.2,51,46.8,61,34,24,23,14,23,62,37.1,39,28,0,28,29,90,16,0,16,27,37.2,"FW,DF"
"Yaya Sanogo","2020-2021",15,14,8,57.1,6,42.9,2,1,1,1,0,0,0,NA,0,2,0,2,0,2,9,0,35,39,47.3,"FW"
"Grant Hall","2020-2021",6,5,5,100,0,0,8,5,5,3,0,5,6,83.3,1,15,11,4,25,33,82,0,127,49,72.2,"DF"
"Maxime Biamou","2020-2021",168,36,13,36.1,23,63.9,26,16,4,12,10,7,24,29.2,17,18,2,16,9,35,17,0,124,158,44,"FW"
"George Moncur","2020-2021",50,12,7,58.3,5,41.7,13,5,3,8,2,7,10,70,3,11,0,11,3,16,1,0,4,7,36.4,"FW,MF"
"Mario Vrančić","2020-2021",100,22,12,54.5,10,45.5,35,22,15,14,6,13,30,43.3,17,10,1,9,16,51,12,0,29,46,38.7,"MF"
"Murray Wallace","2020-2021",27,17,8,47.1,9,52.9,26,16,21,3,2,17,28,60.7,11,22,8,14,28,54,63,0,66,56,54.1,"DF"
"Pontus Jansson","2020-2021",6,4,1,25,3,75,11,8,8,3,0,5,9,55.6,4,11,8,3,25,36,95,0,76,46,62.3,"DF"
"Ken Sema","2020-2021",258,95,40,42.1,55,57.9,52,27,26,22,4,17,46,37,29,24,2,22,26,78,31,0,40,88,31.3,"FW,DF"
"Andrew Hughes","2020-2021",47,15,8,53.3,7,46.7,46,26,27,11,8,24,33,72.7,9,30,14,16,47,93,119,1,176,76,69.8,"DF"
"Robert Glatzel","2020-2021",75,25,16,64,9,36,11,7,2,6,3,0,10,0,10,8,0,8,3,14,9,0,52,92,36.1,"FW"
"Neeskens Kebano","2020-2021",90,32,21,65.6,11,34.4,20,10,10,7,3,11,17,64.7,6,14,0,14,15,35,3,0,20,24,45.5,"FW,MF"
"Geoff Cameron","2020-2021",8,15,11,73.3,4,26.7,49,35,25,19,5,23,55,41.8,32,41,18,23,49,98,89,1,84,71,54.2,"MF,DF"
"Lewis Grabban","2020-2021",108,28,17,60.7,11,39.3,4,4,1,3,0,0,5,0,5,11,4,7,4,8,14,0,15,42,26.3,"FW"
"Michał Helik","2020-2021",13,3,2,66.7,1,33.3,77,48,50,27,0,24,30,80,6,39,16,23,102,179,238,1,259,160,61.8,"DF"
"Wayne Routledge","2020-2021",54,7,3,42.9,4,57.1,6,6,3,1,2,2,9,22.2,7,2,0,2,2,8,4,0,2,19,9.5,"FW"
"Sam Vokes","2020-2021",52,3,2,66.7,1,33.3,3,1,0,2,1,0,1,0,1,3,2,1,0,3,21,0,83,89,48.3,"FW"
"Anfernee Dijksteel","2020-2021",29,30,24,80,6,20,49,34,25,19,5,20,39,51.3,19,30,14,16,55,104,60,0,44,55,44.4,"DF"
"Kyle Vassell","2020-2021",40,18,7,38.9,11,61.1,6,3,2,3,1,4,9,44.4,5,6,0,6,1,7,3,0,11,15,42.3,"FW,MF"
"Adam Smith","2020-2021",183,43,22,51.2,21,48.8,51,38,31,10,10,24,44,54.5,20,27,3,24,28,79,64,2,48,61,44,"DF,MF"
"Liam Cullen","2020-2021",40,8,4,50,4,50,3,2,0,2,1,0,7,0,7,6,0,6,1,4,5,0,15,29,34.1,"FW"
"Tomás Esteves","2020-2021",54,35,21,60,14,40,38,26,23,9,6,16,24,66.7,8,10,1,9,17,55,33,1,10,19,34.5,"DF,FW"
"Daryl Horgan","2020-2021",108,45,20,44.4,25,55.6,30,16,14,9,7,10,35,28.6,25,18,4,14,16,46,23,0,9,37,19.6,"MF,FW"
"Fankaty Dabo","2020-2021",89,61,36,59,25,41,41,27,17,20,4,24,38,63.2,14,19,2,17,19,60,25,0,13,27,32.5,"DF,MF"
"Kadeem Harris","2020-2021",151,118,57,48.3,61,51.7,53,29,26,17,10,20,33,60.6,13,20,5,15,18,71,20,0,17,38,30.9,"DF,MF"
"Alan Browne","2020-2021",110,67,32,47.8,35,52.2,76,42,38,25,13,29,78,37.2,49,55,14,41,58,134,55,0,120,99,54.8,"MF,DF"
"Scott Sinclair","2020-2021",154,57,41,71.9,16,28.1,13,10,6,6,1,8,31,25.8,23,15,0,15,10,23,9,0,6,36,14.3,"FW"
"Darragh Lenihan","2020-2021",11,6,5,83.3,1,16.7,47,27,33,13,1,23,37,62.2,14,46,32,14,64,111,150,0,195,94,67.5,"DF"
"Luke Thomas","2020-2021",44,16,13,81.3,3,18.8,23,9,4,11,8,7,19,36.8,12,15,1,14,2,25,2,0,2,15,11.8,"MF,FW"
"Curtis Thompson","2020-2021",23,42,25,59.5,17,40.5,51,25,23,25,3,17,40,42.5,23,33,13,20,46,97,57,0,68,67,50.4,"MF"
"Yuri Ribeiro","2020-2021",87,38,25,65.8,13,34.2,21,14,14,4,3,8,18,44.4,10,17,9,8,24,45,59,1,63,57,52.5,"DF"
"Ben Wilmot","2020-2021",8,4,2,50,2,50,10,6,4,4,2,9,16,56.3,7,18,6,12,21,31,57,0,35,35,50,"DF"
"Emil Riis Jakobsen","2020-2021",150,41,22,53.7,19,46.3,13,6,0,6,7,5,15,33.3,10,14,2,12,2,15,14,0,50,109,31.4,"FW"
"Shaun Williams","2020-2021",14,7,6,85.7,1,14.3,22,13,11,10,1,8,20,40,12,16,3,13,23,45,18,0,39,24,61.9,"MF"
"Jay Dasilva","2020-2021",23,16,9,56.3,7,43.8,11,9,5,5,1,6,16,37.5,10,9,1,8,9,20,15,0,3,6,33.3,"DF"
"Luke Berry","2020-2021",85,15,10,66.7,5,33.3,14,13,4,7,3,5,23,21.7,18,12,0,12,17,31,12,2,41,60,40.6,"MF"
"Lewis Cook","2020-2021",34,56,40,71.4,16,28.6,39,22,16,18,5,20,53,37.7,33,36,6,30,47,86,12,1,20,27,42.6,"MF"
"Duncan Watmore","2020-2021",117,53,23,43.4,29,54.7,14,5,1,8,5,6,14,42.9,8,16,2,14,8,22,7,0,10,50,16.7,"FW,MF"
"Anthony Gordon","2020-2021",26,17,10,58.8,7,41.2,4,0,1,3,0,2,5,40,3,2,0,2,3,7,4,0,2,8,20,"FW"
"Jamie Allen","2020-2021",38,14,7,50,7,50,17,8,7,6,4,6,30,20,24,14,2,12,11,28,4,0,11,17,39.3,"MF,FW"
"Steven Fletcher","2020-2021",163,21,15,71.4,6,28.6,20,14,4,12,4,3,15,20,12,22,4,18,10,30,17,0,100,134,42.7,"FW"
"Matt Smith","2020-2021",56,2,2,100,0,0,7,2,2,4,1,3,8,37.5,5,5,2,3,2,9,24,0,153,109,58.4,"FW"
"Christoph Zimmermann","2020-2021",0,3,1,33.3,2,66.7,12,10,8,3,1,5,8,62.5,3,14,9,5,11,23,55,0,35,20,63.6,"DF"
"Carlton Morris","2020-2021",84,19,8,42.1,11,57.9,13,7,0,8,5,4,8,50,4,10,1,9,5,18,14,0,60,74,44.8,"MF,FW"
"Harry Arter","2020-2021",11,2,1,50,1,50,19,12,4,12,3,9,24,37.5,15,8,3,5,5,24,7,0,2,3,40,"MF"
"Kieran Dowell","2020-2021",68,13,7,53.8,6,46.2,16,9,3,11,2,3,14,21.4,11,12,1,11,5,21,5,1,8,27,22.9,"MF,FW"
"Maxime Colin","2020-2021",99,47,27,57.4,20,42.6,72,44,36,27,9,33,59,55.9,26,45,14,31,57,129,78,0,58,65,47.2,"DF"
"Daniel Ayala","2020-2021",1,2,2,100,0,0,12,9,10,2,0,3,5,60,2,8,7,1,11,23,41,0,31,30,50.8,"DF"
"Liam Lindsay","2020-2021",2,3,1,33.3,2,66.7,18,10,15,3,0,10,15,66.7,5,17,13,4,26,44,58,2,61,47,56.5,"DF"
"Mads Bech Sørensen","2020-2021",13,5,2,40,3,60,36,22,23,12,1,25,33,75.8,8,22,12,10,30,66,119,0,59,71,45.4,"DF"
"Britt Assombalonga","2020-2021",108,30,14,46.7,16,53.3,0,0,0,0,0,0,2,0,2,3,0,3,1,1,10,0,48,113,29.8,"FW"
"Rabbi Matondo","2020-2021",39,29,12,41.4,17,58.6,7,3,0,6,1,1,6,16.7,5,5,0,5,1,8,0,0,5,16,23.8,"DF,MF"
"Clark Robertson","2020-2021",5,1,1,100,0,0,6,4,3,2,1,1,3,33.3,2,8,4,4,16,22,57,0,47,36,56.6,"DF"
"Lewis Travis","2020-2021",18,16,14,87.5,2,12.5,39,25,12,25,2,20,30,66.7,10,29,6,23,19,58,10,1,8,18,30.8,"MF"
"Adam Reach","2020-2021",186,69,32,46.4,37,53.6,43,29,28,12,3,18,55,32.7,37,37,2,35,39,82,50,0,25,30,45.5,"DF,MF"
"Ryan Ledson","2020-2021",28,25,13,52,12,48,89,61,25,59,5,42,108,38.9,66,41,13,28,47,136,38,1,46,27,63,"MF"
"Junior Hoilett","2020-2021",88,23,16,69.6,7,30.4,24,16,10,8,6,10,19,52.6,9,7,1,6,18,42,8,0,14,17,45.2,"FW,MF"
"Tobias Figueiredo","2020-2021",2,5,5,100,0,0,25,12,19,5,1,12,20,60,8,32,24,8,48,73,166,1,95,76,55.6,"DF"
"Dan Potts","2020-2021",26,12,5,41.7,7,58.3,15,7,6,6,3,9,14,64.3,5,18,7,11,26,41,54,0,73,46,61.3,"DF"
"Alex Mowatt","2020-2021",65,29,21,72.4,8,27.6,76,35,38,27,11,35,79,44.3,44,53,8,45,37,113,55,0,68,59,53.5,"MF"
"Jeremy Ngakia","2020-2021",75,43,27,62.8,16,37.2,63,34,40,16,7,27,40,67.5,13,27,2,25,33,96,37,0,18,24,42.9,"DF"
"Tom Lockyer","2020-2021",4,6,4,66.7,2,33.3,19,9,14,5,0,12,15,80,3,21,14,7,24,43,61,0,53,46,53.5,"DF"
"Joe Ralls","2020-2021",66,26,18,69.2,8,30.8,81,44,39,33,9,25,55,45.5,30,29,9,20,34,115,49,0,55,49,52.9,"MF"
"Fred Onyedinma","2020-2021",114,87,38,43.7,49,56.3,47,30,26,14,7,12,22,54.5,10,28,3,25,25,72,27,0,50,74,40.3,"MF,FW"
"Tyrese Campbell","2020-2021",104,33,19,57.6,14,42.4,4,4,0,2,2,0,13,0,13,9,0,9,4,8,5,0,13,22,37.1,"FW,MF"
"Connor Mahoney","2020-2021",37,10,3,30,7,70,3,1,2,1,0,2,4,50,2,9,0,9,7,10,3,0,1,10,9.1,"MF,FW"
"Callum O'Hare","2020-2021",288,124,69,55.6,55,44.4,90,51,29,40,21,21,83,25.3,62,68,3,65,23,113,11,0,24,83,22.4,"MF,FW"
"Dan McNamara","2020-2021",54,26,14,53.8,12,46.2,22,12,11,8,3,9,16,56.3,7,12,5,7,15,37,21,0,18,26,40.9,"DF,MF"
"Lukas Jutkiewicz","2020-2021",137,13,4,30.8,9,69.2,17,11,4,8,5,2,14,14.3,12,32,7,25,7,24,44,1,240,196,55,"FW"
"Marc Bola","2020-2021",90,50,31,62,19,38,62,40,32,25,5,20,28,71.4,8,50,12,38,69,131,83,1,84,56,60,"DF,FW"
"Lee Gregory","2020-2021",62,15,5,33.3,10,66.7,6,0,1,3,2,1,5,20,4,11,1,10,1,7,4,0,21,46,31.3,"FW"
"Amari'i Bell","2020-2021",66,26,13,50,13,50,28,18,18,6,4,18,32,56.3,14,15,2,13,20,48,34,1,35,25,58.3,"DF"
"Jordan Rhodes","2020-2021",55,3,3,100,0,0,6,6,1,3,2,3,9,33.3,6,16,6,10,3,9,18,0,68,113,37.6,"FW"
"Joe Morrell","2020-2021",2,2,0,0,2,100,12,7,7,5,0,6,18,33.3,12,4,2,2,8,20,8,0,3,5,37.5,"MF"
"Jordy de Wijs","2020-2021",1,1,1,100,0,0,9,5,7,2,0,5,6,83.3,1,9,7,2,12,21,47,0,32,12,72.7,"DF"
"Rekeem Harper","2020-2021",9,15,13,86.7,2,13.3,13,6,4,9,0,5,9,55.6,4,14,3,11,6,19,6,1,22,13,62.9,"MF"
"Jordan Shipley","2020-2021",54,7,4,57.1,3,42.9,22,11,7,11,4,11,32,34.4,21,13,1,12,10,32,9,0,10,24,29.4,"MF,FW"
"Przemysław Płacheta","2020-2021",127,29,15,51.7,14,48.3,18,12,8,5,5,8,21,38.1,13,7,1,6,3,21,8,0,6,25,19.4,"FW,MF"
"Garath McCleary","2020-2021",121,35,14,40,21,60,26,16,9,11,6,6,25,24,19,22,3,19,11,37,21,0,28,37,43.1,"MF,FW"
"Tariqe Fosu","2020-2021",140,76,43,56.6,33,43.4,45,21,27,11,7,14,34,41.2,20,27,2,25,18,63,15,0,15,51,22.7,"FW,MF"
"Corry Evans","2020-2021",20,3,2,66.7,1,33.3,20,13,7,11,2,4,10,40,6,10,1,9,18,38,9,0,11,14,44,"MF"
"Steve Cook","2020-2021",3,6,5,83.3,1,16.7,26,14,19,7,0,9,16,56.3,7,37,32,5,58,84,177,5,170,74,69.7,"DF"
"Lyle Taylor","2020-2021",148,20,10,50,10,50,7,4,1,3,3,4,12,33.3,8,17,2,15,5,12,14,0,30,83,26.5,"FW"
"Josh Martin","2020-2021",29,14,8,57.1,6,42.9,7,4,3,4,0,3,14,21.4,11,9,0,9,2,9,2,0,0,5,0,"FW"
"Lukas Rupp","2020-2021",91,26,15,57.7,11,42.3,39,25,16,18,5,10,26,38.5,16,24,4,20,19,58,14,0,12,15,44.4,"MF"
"George Evans","2020-2021",11,10,7,70,3,30,39,24,21,17,1,12,23,52.2,11,27,9,18,45,84,40,1,48,52,48,"DF,MF"
"Lewis Holtby","2020-2021",52,12,9,75,3,25,36,22,18,16,2,13,44,29.5,31,15,4,11,20,56,23,0,13,19,40.6,"MF"
"Nathaniel Chalobah","2020-2021",52,37,27,73,10,27,59,31,23,31,5,28,66,42.4,38,26,8,18,52,111,54,2,66,50,56.9,"MF"
"John Obi Mikel","2020-2021",20,36,27,75,9,25,59,40,13,42,4,24,56,42.9,32,45,17,28,29,88,31,2,59,46,56.2,"MF"
"Joshua King","2020-2021",54,20,10,50,10,50,6,2,1,3,2,1,2,50,1,4,1,3,1,7,5,0,8,19,29.6,"FW"
"Jay Fulton","2020-2021",94,34,20,58.8,14,41.2,110,66,47,50,13,30,59,50.8,29,38,12,26,45,155,40,0,60,50,54.5,"MF"
"Troy Parrott","2020-2021",30,18,13,72.2,5,27.8,3,2,1,2,0,0,7,0,7,4,2,2,3,6,3,0,7,20,25.9,"FW,MF"
"Dael Fry","2020-2021",8,4,3,75,1,25,28,17,18,10,0,12,19,63.2,7,41,26,15,56,84,127,1,195,107,64.6,"DF"
"Matt Crooks","2020-2021",126,56,26,46.4,30,53.6,52,28,17,28,7,18,64,28.1,46,39,6,33,22,74,47,0,102,72,58.6,"MF,FW"
"Niko Hämäläinen","2020-2021",61,15,8,53.3,7,46.7,27,14,19,7,1,16,26,61.5,10,14,2,12,21,48,42,0,21,32,39.6,"DF"
"Sam Gallagher","2020-2021",140,75,32,42.7,43,57.3,29,19,14,11,4,12,25,48,13,21,4,17,17,46,28,0,132,127,51,"FW"
"Jed Wallace","2020-2021",286,144,79,54.9,65,45.1,46,29,18,20,8,16,69,23.2,53,31,0,31,15,61,11,0,12,52,18.8,"FW,MF"
"Kasey Palmer","2020-2021",57,66,45,68.2,21,31.8,46,31,21,17,8,15,42,35.7,27,24,2,22,16,62,16,0,41,60,40.6,"MF,FW"
"Wes Harding","2020-2021",55,36,14,38.9,22,61.1,60,39,36,20,4,28,52,53.8,24,46,8,38,88,148,108,2,75,72,51,"DF"
"Adam Clayton","2020-2021",1,7,3,42.9,4,57.1,14,8,6,6,2,5,23,21.7,18,12,6,6,15,29,16,1,10,7,58.8,"MF"
"Lee Buchanan","2020-2021",110,46,21,45.7,25,54.3,55,29,36,14,5,28,39,71.8,11,37,8,29,33,88,100,2,102,73,58.3,"DF,MF"
"Max Bird","2020-2021",28,20,15,75,5,25,55,33,22,28,5,24,51,47.1,27,27,9,18,29,84,20,0,22,29,43.1,"MF"
"George Edmundson","2020-2021",3,5,3,60,2,40,14,9,9,5,0,6,9,66.7,3,4,1,3,5,19,35,0,36,24,60,"DF"
"Kenny McLean","2020-2021",72,31,19,61.3,12,38.7,44,31,18,19,7,16,37,43.2,21,32,9,23,37,81,44,1,81,59,57.9,"MF"
"Taylor Harwood-Bellis","2020-2021",4,1,0,0,1,100,16,11,12,3,1,8,11,72.7,3,21,13,8,30,46,53,0,56,49,53.3,"DF"
"Duane Holmes","2020-2021",116,44,21,47.7,23,52.3,21,14,9,9,3,9,36,25,27,23,2,21,13,34,18,0,11,38,22.4,"MF,FW"
"Harlee Dean","2020-2021",14,17,11,64.7,6,35.3,29,19,14,14,1,18,31,58.1,13,48,31,17,57,86,158,2,244,126,65.9,"DF"
"Anis Mehmeti","2020-2021",53,60,34,56.7,26,43.3,20,9,4,10,6,9,25,36,16,12,0,12,3,23,2,0,15,31,32.6,"MF"
"Aaron Rowe","2020-2021",57,34,17,50,17,50,14,10,6,4,4,7,10,70,3,21,3,18,10,24,12,0,5,16,23.8,"DF,FW"
"Maikel Kieftenbeld","2020-2021",8,10,7,70,3,30,37,22,11,25,1,21,42,50,21,12,3,9,38,75,24,0,17,15,53.1,"MF"
"Viktor Gyökeres","2020-2021",95,35,16,45.7,19,54.3,13,5,1,5,7,4,13,30.8,9,11,1,10,7,20,9,0,22,79,21.8,"FW"
"Joe Rafferty","2020-2021",27,9,5,55.6,4,44.4,12,9,9,1,2,6,11,54.5,5,9,5,4,30,42,40,0,27,27,50,"DF"
"Emiliano Marcondes","2020-2021",51,2,0,0,2,100,26,14,14,9,3,12,27,44.4,15,23,4,19,8,34,18,0,19,33,36.5,"MF"
"James Garner","2020-2021",42,32,20,62.5,12,37.5,57,30,20,31,6,22,65,33.8,43,39,8,31,47,104,42,1,35,44,44.3,"MF"
"Steven Sessegnon","2020-2021",13,9,3,33.3,6,66.7,14,9,9,3,2,5,12,41.7,7,10,4,6,17,31,28,0,13,20,39.4,"DF,FW"
"Matthew Godden","2020-2021",78,4,4,100,0,0,1,0,1,0,0,1,5,20,4,8,2,6,2,3,8,0,44,77,36.4,"FW"
"Scott McKenna","2020-2021",3,10,8,80,2,20,17,9,13,4,0,4,5,80,1,23,18,5,22,39,79,1,89,45,66.4,"DF"
"Conor Chaplin","2020-2021",185,24,9,37.5,15,62.5,26,19,9,11,6,11,45,24.4,34,39,2,37,20,46,11,0,17,65,20.7,"FW,MF"
"George Friend","2020-2021",50,38,18,47.4,20,52.6,36,20,21,11,4,11,21,52.4,10,22,14,8,33,69,69,0,94,63,59.9,"DF"
"Dennis Adeniran","2020-2021",12,27,21,77.8,6,22.2,24,14,6,13,5,4,14,28.6,10,15,6,9,32,56,18,0,20,19,51.3,"MF"
"Nicholas Ioannou","2020-2021",17,6,2,33.3,4,66.7,11,7,5,5,1,3,6,50,3,7,1,6,10,21,5,0,7,7,50,"DF"
"Kristian Pedersen","2020-2021",85,63,40,63.5,23,36.5,66,42,43,18,5,24,44,54.5,20,29,9,20,77,143,118,1,154,82,65.3,"DF"
"Marc Roberts","2020-2021",12,3,3,100,0,0,44,27,33,11,0,18,26,69.2,8,23,16,7,42,86,166,2,222,91,70.9,"DF"
"Ryan Tunnicliffe","2020-2021",48,11,4,36.4,7,63.6,21,16,3,16,2,10,20,50,10,17,7,10,17,38,21,0,14,22,38.9,"MF"
"James McClean","2020-2021",111,41,15,36.6,26,63.4,34,19,17,11,6,16,49,32.7,33,16,1,15,17,51,34,0,41,28,59.4,"FW,DF"
"Bradley Dack","2020-2021",42,12,5,41.7,7,58.3,5,2,2,1,2,2,8,25,6,5,2,3,3,8,6,0,5,13,27.8,"MF,FW"
"Tom Trybull","2020-2021",3,6,6,100,0,0,37,25,13,20,4,12,34,35.3,22,29,9,20,43,80,32,1,45,31,59.2,"MF"
"Jack Stacey","2020-2021",140,32,20,62.5,12,37.5,27,17,10,16,1,11,22,50,11,21,3,18,25,52,35,0,30,28,51.7,"DF,MF"
"Winston Reid","2020-2021",0,1,1,100,0,0,6,3,5,1,0,4,5,80,1,11,6,5,16,22,26,0,45,16,73.8,"DF"
"Henrik Dalsgaard","2020-2021",80,26,22,84.6,4,15.4,55,32,38,14,3,31,59,52.5,28,14,4,10,39,94,80,1,85,49,63.4,"DF"
"Jérémie Bela","2020-2021",164,86,42,48.8,44,51.2,22,15,10,10,2,7,12,58.3,5,16,1,15,15,37,10,0,17,49,25.8,"FW,MF"
"Ben Brereton","2020-2021",222,105,54,51.4,51,48.6,34,19,11,18,5,15,31,48.4,16,9,1,8,17,51,9,0,28,56,33.3,"FW"
"Ciaron Brown","2020-2021",11,4,1,25,3,75,18,9,12,5,1,7,10,70,3,13,7,6,14,32,34,0,35,24,59.3,"DF"
"Mads Roerslev","2020-2021",57,16,6,37.5,10,62.5,13,9,9,4,0,8,13,61.5,5,4,1,3,7,20,13,0,5,9,35.7,"DF,FW"
"Joe Jacobson","2020-2021",18,13,10,76.9,3,23.1,68,44,33,34,1,36,68,52.9,32,43,17,26,71,139,114,3,83,76,52.2,"DF"
"Andreas Weimann","2020-2021",28,4,2,50,2,50,8,6,4,2,2,5,8,62.5,3,4,0,4,3,11,7,0,3,4,42.9,"MF"
"Dominik Frieser","2020-2021",125,21,6,28.6,15,71.4,13,7,4,6,3,4,37,10.8,33,18,1,17,15,28,14,0,12,77,13.5,"MF,FW"
"Riley McGree","2020-2021",33,28,16,57.1,12,42.9,14,10,4,10,0,7,17,41.2,10,5,1,4,7,21,5,0,7,8,46.7,"MF,DF"
"Patrick Roberts","2020-2021",60,73,33,45.2,39,53.4,8,4,2,5,1,2,18,11.1,16,8,0,8,3,11,2,0,0,12,0,"MF,FW"
"Steve Seddon","2020-2021",13,3,0,0,3,100,7,5,5,1,1,2,5,40,3,2,0,2,5,12,12,0,13,14,48.1,"DF"
"Tom Carroll","2020-2021",55,17,6,35.3,11,64.7,29,13,12,14,3,7,26,26.9,19,9,3,6,14,43,19,0,14,27,34.1,"MF"
"Sone Aluko","2020-2021",66,54,31,57.4,23,42.6,14,10,3,9,2,8,27,29.6,19,16,1,15,12,26,8,0,5,13,27.8,"FW,MF"
"Étienne Capoue","2020-2021",3,15,12,80,3,20,22,12,11,8,3,7,14,50,7,9,5,4,31,53,12,0,7,9,43.8,"MF"
"Elias Kachunga","2020-2021",62,27,12,44.4,15,55.6,15,9,5,7,3,4,8,50,4,6,0,6,7,22,10,0,25,57,30.5,"FW,MF"
"Josh Knight","2020-2021",8,20,14,70,6,30,43,30,27,15,1,21,46,45.7,25,57,32,25,63,106,139,1,86,89,49.1,"DF,MF"
"Marcus Tavernier","2020-2021",126,66,35,53,31,47,49,29,19,24,6,22,39,56.4,17,32,4,28,13,62,15,0,47,85,35.6,"MF,FW"
"Glen Rea","2020-2021",8,17,14,82.4,3,17.6,58,37,26,30,2,32,70,45.7,38,42,15,27,74,132,87,1,93,79,54.1,"MF,DF"
"Kiernan Dewsbury-Hall","2020-2021",87,75,48,64,27,36,61,32,22,33,6,34,71,47.9,37,41,8,33,47,108,40,1,40,39,50.6,"MF"
"André Ayew","2020-2021",265,109,67,61.5,41,37.6,32,13,8,19,5,7,31,22.6,24,25,6,19,9,41,65,1,122,250,32.8,"FW"
"Kenneth Zohore","2020-2021",43,13,7,53.8,6,46.2,3,2,1,2,0,1,6,16.7,5,5,0,5,1,4,9,0,45,79,36.3,"FW"
"Ryan Tafazolli","2020-2021",4,3,2,66.7,1,33.3,12,7,7,3,2,5,7,71.4,2,22,12,10,17,29,90,0,115,51,69.3,"DF"
"Demeaco Duhaney","2020-2021",16,6,3,50,3,50,6,3,3,3,0,1,7,14.3,6,1,0,1,8,14,10,0,13,13,50,"DF"
"Jordan Obita","2020-2021",4,3,2,66.7,1,33.3,14,8,7,7,0,5,10,50,5,8,4,4,7,21,16,0,8,11,42.1,"DF"
"Josh Dasilva","2020-2021",103,76,47,61.8,29,38.2,20,10,7,10,3,8,22,36.4,14,15,2,13,6,26,19,0,10,19,34.5,"MF"
"Michael Rose","2020-2021",12,4,3,75,1,25,15,8,8,6,1,4,10,40,6,8,6,2,21,36,48,1,42,21,66.7,"DF"
"Tommy Rowe","2020-2021",53,17,9,52.9,8,47.1,38,15,21,16,1,23,39,59,16,22,6,16,62,100,64,0,60,51,54.1,"DF"
"Curtis Davies","2020-2021",1,4,4,100,0,0,15,10,12,3,0,7,12,58.3,5,10,8,2,19,34,59,0,49,26,65.3,"DF"
"Jack Hunt","2020-2021",109,49,17,34.7,32,65.3,46,27,32,8,6,26,56,46.4,30,28,7,21,51,97,86,0,29,50,36.7,"DF"
"Joe Rankin-Costello","2020-2021",70,13,6,46.2,7,53.8,19,12,10,5,4,10,16,62.5,6,13,6,7,24,43,29,0,24,23,51.1,"DF"
"Oliver Skipp","2020-2021",71,40,26,65,14,35,100,56,38,54,8,30,63,47.6,33,57,21,36,50,150,54,0,61,86,41.5,"MF"
"Luke Freeman","2020-2021",76,26,23,88.5,3,11.5,15,7,3,9,3,3,12,25,9,10,1,9,12,27,6,0,11,36,23.4,"FW,MF"
"Jason McCarthy","2020-2021",43,13,4,30.8,9,69.2,23,12,17,5,1,15,21,71.4,6,22,9,13,24,47,57,0,49,37,57,"DF"
"Shaun Hutchinson","2020-2021",13,12,7,58.3,5,41.7,59,38,42,15,2,25,43,58.1,18,45,25,20,99,158,160,1,183,79,69.8,"DF"
"John Swift","2020-2021",30,15,12,80,3,20,5,2,0,2,3,1,7,14.3,6,3,0,3,2,7,5,0,6,13,31.6,"MF"
"Adama Diakhaby","2020-2021",53,20,8,40,12,60,9,3,5,3,1,3,9,33.3,6,5,0,5,10,19,7,0,15,8,65.2,"FW"
"Julien Dacosta","2020-2021",72,22,10,45.5,12,54.5,24,12,15,5,4,16,30,53.3,14,10,1,9,15,39,24,1,18,12,60,"DF"
"Dominic Iorfa","2020-2021",6,7,4,57.1,3,42.9,12,7,9,3,0,3,6,50,3,8,4,4,18,30,20,0,27,30,47.4,"DF,MF"
"Tyler Walker","2020-2021",127,17,8,47.1,9,52.9,13,6,2,4,7,3,3,100,0,8,0,8,3,16,13,0,64,111,36.6,"FW"
"Emi Buendía","2020-2021",224,101,63,62.4,38,37.6,93,53,40,41,12,40,110,36.4,70,65,3,62,41,134,56,0,37,74,33.3,"FW"
"Alex Pearce","2020-2021",1,2,2,100,0,0,17,10,16,1,0,6,11,54.5,5,18,10,8,38,55,108,0,72,39,64.9,"DF"
"Jake Bidwell","2020-2021",204,15,6,40,9,60,23,11,11,9,3,9,19,47.4,10,30,11,19,24,47,85,0,107,76,58.5,"DF"
"Tom Ince","2020-2021",42,14,4,28.6,10,71.4,8,5,1,6,1,2,4,50,2,4,1,3,1,9,1,0,6,12,33.3,"FW,MF"
"Jordan Williams","2020-2021",27,16,8,50,8,50,20,14,12,7,1,9,13,69.2,4,16,2,14,9,29,22,0,20,21,48.8,"DF,MF"
"Josh Koroma","2020-2021",150,46,22,47.8,24,52.2,16,11,7,6,3,6,20,30,14,9,1,8,3,19,11,0,10,25,28.6,"FW"
"Junior Stanislas","2020-2021",183,48,32,66.7,16,33.3,13,6,2,7,4,5,9,55.6,4,9,0,9,0,13,14,0,11,41,21.2,"FW,MF"
"Bryan Mbeumo","2020-2021",240,78,36,46.2,42,53.8,36,16,14,12,10,13,33,39.4,20,25,4,21,26,62,30,1,38,69,35.5,"FW"
"Joe Mattock","2020-2021",30,10,6,60,4,40,27,18,14,9,4,14,22,63.6,8,6,0,6,21,48,28,0,31,23,57.4,"DF"
"Scott Kashket","2020-2021",78,25,7,28,18,72,17,8,8,7,2,6,20,30,14,17,3,14,1,18,5,0,3,23,11.5,"FW,MF"
"Ben Wiles","2020-2021",108,54,30,55.6,24,44.4,48,33,14,28,6,25,68,36.8,43,28,6,22,45,93,31,0,19,46,29.2,"MF,DF"
"Jordan Thompson","2020-2021",37,15,9,60,6,40,25,13,11,11,3,10,30,33.3,20,17,6,11,15,40,31,0,19,21,47.5,"MF"
"Anthony Knockaert","2020-2021",169,86,46,53.5,40,46.5,29,15,13,9,7,11,29,37.9,18,17,0,17,34,63,8,0,12,28,30,"FW,MF"
"Taylor Moore","2020-2021",2,4,2,50,2,50,14,12,11,3,0,7,17,41.2,10,13,9,4,31,45,49,2,62,50,55.4,"DF"
"Tom Cleverley","2020-2021",78,12,9,75,3,25,76,36,32,40,4,27,66,40.9,39,39,6,33,24,100,28,1,25,28,47.2,"MF"
"Daniel Johnson","2020-2021",82,26,17,65.4,9,34.6,27,21,6,11,10,7,18,38.9,11,24,7,17,14,41,14,0,20,24,45.5,"MF"
"Graeme Shinnie","2020-2021",39,46,35,76.1,11,23.9,85,51,37,44,4,32,76,42.1,44,44,7,37,49,134,52,0,51,48,51.5,"MF"
"Tom McIntyre","2020-2021",11,14,7,50,7,50,33,21,19,13,1,12,16,75,4,22,7,15,38,71,75,0,83,42,66.4,"DF,MF"
"Craig Forsyth","2020-2021",58,11,6,54.5,5,45.5,13,10,7,3,3,9,16,56.3,7,16,3,13,19,32,56,1,53,47,53,"DF"
"Iván Sánchez","2020-2021",121,72,48,66.7,24,33.3,64,35,28,27,9,28,70,40,42,36,3,33,28,92,10,0,16,49,24.6,"FW,MF"
"Yannick Bolasie","2020-2021",53,31,14,45.2,17,54.8,11,6,4,3,4,4,6,66.7,2,6,1,5,1,12,13,0,47,39,54.7,"FW,MF"
"Ryan Giles","2020-2021",133,46,25,54.3,21,45.7,37,22,25,11,1,23,34,67.6,11,22,1,21,26,63,33,0,15,21,41.7,"DF,MF"
"Mickel Miller","2020-2021",42,20,9,45,11,55,11,6,6,4,1,2,6,33.3,4,4,0,4,10,21,5,0,9,21,30,"FW,MF"
"Alexander Tettey","2020-2021",2,7,6,85.7,1,14.3,3,2,1,2,0,3,12,25,9,4,0,4,7,10,8,0,9,8,52.9,"MF"
"Moses Odubajo","2020-2021",23,28,14,50,14,50,30,17,23,5,2,8,15,53.3,7,11,3,8,23,53,32,0,20,22,47.6,"DF"
"Jonathan Leko","2020-2021",105,91,47,51.6,44,48.4,19,7,8,7,4,8,19,42.1,11,4,0,4,7,26,1,1,6,43,12.2,"FW,MF"
"Jack Simpson","2020-2021",2,3,2,66.7,1,33.3,9,6,6,1,2,0,1,0,1,12,6,6,8,17,22,0,20,26,43.5,"DF"
"Max Aarons","2020-2021",288,107,61,57,46,43,31,18,23,6,2,19,33,57.6,14,23,9,14,39,70,101,0,37,62,37.4,"DF"
"Will Vaulks","2020-2021",28,15,10,66.7,5,33.3,52,24,15,33,4,18,79,22.8,61,39,9,30,51,103,43,0,102,48,68,"MF"
"Ádám Nagy","2020-2021",37,20,12,60,8,40,33,18,18,14,1,19,46,41.3,27,33,6,27,55,88,24,1,11,27,28.9,"MF"
"Chiedozie Ogbene","2020-2021",39,31,15,48.4,16,51.6,8,8,4,2,2,6,6,100,0,3,0,3,5,13,4,0,10,27,27,"MF,FW"
"George Hirst","2020-2021",41,13,5,38.5,8,61.5,2,1,0,2,0,0,3,0,3,4,0,4,0,2,6,0,50,86,36.8,"FW"
"Dominic Ball","2020-2021",38,39,23,59,16,41,32,21,14,13,5,14,40,35,26,21,7,14,27,59,34,0,49,39,55.7,"MF"
"Charlie Goode","2020-2021",2,1,1,100,0,0,3,1,2,1,0,3,3,100,0,3,3,0,4,7,17,1,22,11,66.7,"DF"
"Ben Sheaf","2020-2021",17,20,12,60,8,40,53,32,26,23,4,25,60,41.7,35,28,8,20,22,75,29,1,25,36,41,"MF"
"Ben Whiteman","2020-2021",3,7,6,85.7,1,14.3,34,15,12,21,1,17,34,50,17,18,12,6,28,62,30,0,23,17,57.5,"MF"
"Jordan Clark","2020-2021",132,56,27,48.2,29,51.8,38,24,17,17,4,20,54,37,34,33,8,25,29,67,46,0,39,76,33.9,"DF,MF"
"Jayden Stockley","2020-2021",35,2,1,50,1,50,0,0,0,0,0,0,2,0,2,3,1,2,0,0,12,0,59,68,46.5,"FW,DF"
"Tom Lawrence","2020-2021",92,55,29,52.7,26,47.3,32,22,8,17,7,12,30,40,18,25,2,23,10,42,15,0,7,31,18.4,"FW,MF"
"Cyrus Christie","2020-2021",144,71,43,60.6,28,39.4,77,46,50,17,10,47,75,62.7,28,56,25,31,69,146,114,2,84,64,56.8,"DF"
"William Troost-Ekong","2020-2021",1,3,2,66.7,1,33.3,28,17,18,10,0,15,27,55.6,12,29,20,9,21,49,125,2,78,82,48.8,"DF"
"George Thomas","2020-2021",43,2,1,50,1,50,5,1,1,2,2,3,4,75,1,5,1,4,4,9,8,0,5,8,38.5,"MF,FW"
"Seán Maguire","2020-2021",106,20,7,35,13,65,12,6,4,7,1,4,14,28.6,10,17,0,17,4,16,11,0,39,108,26.5,"FW"
"Dan Gosling","2020-2021",44,26,15,57.7,11,42.3,34,17,16,14,4,15,36,41.7,21,22,7,15,19,53,17,0,18,22,45,"MF"
"Sam Hutchinson","2020-2021",9,8,3,37.5,5,62.5,39,22,20,16,3,12,24,50,12,23,14,9,41,80,67,0,53,26,67.1,"DF,MF"
"Matt Grimes","2020-2021",39,37,26,70.3,11,29.7,93,43,28,60,5,37,89,41.6,52,41,18,23,66,159,71,1,80,86,48.2,"MF"
"Fraizer Campbell","2020-2021",114,36,23,63.9,13,36.1,29,20,8,14,7,10,25,40,15,24,1,23,20,49,46,1,61,111,35.5,"FW"
"Marcus Forss","2020-2021",66,20,6,30,14,70,9,6,2,5,2,3,11,27.3,8,9,0,9,5,14,8,0,4,41,8.9,"FW,MF"
"Troy Deeney","2020-2021",66,13,8,61.5,5,38.5,14,8,6,8,0,5,16,31.3,11,9,1,8,5,19,23,0,65,74,46.8,"FW"
"Vitaly Janelt","2020-2021",34,20,18,90,2,10,73,44,39,32,2,33,61,54.1,28,39,15,24,59,132,49,1,52,44,54.2,"MF"
"Ryan Manning","2020-2021",49,7,4,57.1,3,42.9,31,23,19,9,3,16,27,59.3,11,17,3,14,20,51,28,0,21,13,61.8,"DF"
"Cafú","2020-2021",55,33,17,51.5,16,48.5,12,7,5,6,1,7,30,23.3,23,11,4,7,22,34,16,2,25,49,33.8,"MF"
"Marlon Pack","2020-2021",20,25,20,80,5,20,37,27,19,11,7,9,37,24.3,28,13,6,7,28,65,56,6,72,40,64.3,"MF"
"Cameron Carter-Vickers","2020-2021",1,6,6,100,0,0,21,14,14,6,1,10,12,83.3,2,25,14,11,24,45,76,0,60,45,57.1,"DF"
"Billy Mitchell","2020-2021",13,5,4,80,1,20,26,17,13,11,2,11,17,64.7,6,9,0,9,11,37,14,0,15,30,33.3,"MF"
"Craig Cathcart","2020-2021",9,4,2,50,2,50,32,19,25,6,1,15,19,78.9,4,19,11,8,22,54,80,0,56,41,57.7,"DF"
"Jon Toral","2020-2021",50,10,7,70,3,30,15,9,3,7,5,5,17,29.4,12,16,1,15,1,16,5,0,29,31,48.3,"MF"
"Rico Henry","2020-2021",117,56,31,55.4,25,44.6,38,24,27,9,2,25,41,61,16,18,3,15,27,65,62,0,46,64,41.8,"DF"
"Adrian Mariappa","2020-2021",11,6,4,66.7,2,33.3,26,21,16,10,0,15,29,51.7,14,21,12,9,28,54,93,2,69,40,63.3,"DF"
"Paddy McNair","2020-2021",44,32,22,68.8,10,31.3,85,62,50,28,7,56,80,70,24,41,17,24,59,144,89,1,87,69,55.8,"DF"
"Jamie Paterson","2020-2021",57,44,17,38.6,27,61.4,17,9,8,8,1,8,31,25.8,23,14,3,11,19,36,4,0,4,14,22.2,"MF"
"Tom Lees","2020-2021",4,2,1,50,1,50,46,28,31,15,0,17,21,81,4,37,25,12,68,114,209,2,187,115,61.9,"DF"
"Charlie Austin","2020-2021",77,23,11,47.8,12,52.2,13,7,2,9,2,4,9,44.4,5,9,1,8,5,18,9,0,19,43,30.6,"FW"
"Krystian Bielik","2020-2021",8,17,16,94.1,1,5.9,27,19,12,14,1,5,15,33.3,10,15,4,11,26,53,29,0,46,32,59,"MF"
"Matthew Clarke","2020-2021",9,17,15,88.2,2,11.8,60,38,36,22,2,27,40,67.5,13,32,19,13,58,118,181,1,234,89,72.4,"DF"
"Martyn Waghorn","2020-2021",105,41,17,41.5,24,58.5,14,12,6,5,3,4,20,20,16,21,1,20,8,22,13,0,23,53,30.3,"FW,MF"
"Loïc Mbe Soh","2020-2021",0,1,1,100,0,0,2,1,2,0,0,1,1,100,0,3,3,0,3,5,23,1,12,12,50,"DF"
"Toby Sibbick","2020-2021",0,3,2,66.7,1,33.3,32,20,21,11,0,14,20,70,6,11,1,10,18,50,36,1,53,30,63.9,"DF"
"Christian Kabasele","2020-2021",0,7,6,85.7,1,14.3,15,12,7,7,1,8,14,57.1,6,24,16,8,17,32,64,0,62,42,59.6,"DF"
"Harry Cornick","2020-2021",201,103,56,54.4,47,45.6,28,23,10,9,9,10,34,29.4,24,30,0,30,7,35,7,0,27,86,23.9,"FW,MF"
"Teden Mengi","2020-2021",3,1,0,0,1,100,9,5,9,0,0,2,3,66.7,1,2,2,0,10,19,25,0,23,19,54.8,"DF"
"Daniel Barlaser","2020-2021",24,24,14,58.3,10,41.7,46,29,23,22,1,25,49,51,24,38,8,30,41,87,22,1,49,25,66.2,"MF"
"Perry Ng","2020-2021",36,13,6,46.2,7,53.8,38,27,17,17,4,12,22,54.5,10,27,6,21,17,55,47,0,21,23,47.7,"DF"
"Jonathan Hogg","2020-2021",14,8,4,50,4,50,72,46,50,21,1,34,69,49.3,35,45,12,33,42,114,69,1,69,44,61.1,"MF"
"Liam Palmer","2020-2021",81,27,12,44.4,15,55.6,50,34,33,13,4,23,39,59,16,30,16,14,45,95,81,0,19,33,36.5,"DF"
"Mouhamadou-Naby Sarr","2020-2021",9,19,13,68.4,6,31.6,30,18,19,11,0,19,37,51.4,18,57,41,16,52,82,209,4,126,65,66,"DF"
"Curtis Nelson","2020-2021",6,3,1,33.3,2,66.7,45,32,32,12,1,20,26,76.9,6,48,39,9,60,105,200,0,258,105,71.1,"DF"
"Barry Bannan","2020-2021",69,91,69,75.8,22,24.2,62,36,25,32,5,34,73,46.6,39,35,6,29,54,116,35,0,13,37,26,"MF"
"Sonny Bradley","2020-2021",7,3,3,100,0,0,37,28,26,9,2,20,35,57.1,15,40,26,14,53,90,179,1,130,72,64.4,"DF"
"Aden Flint","2020-2021",12,1,1,100,0,0,18,12,8,10,0,7,16,43.8,9,37,28,9,31,49,156,0,156,84,65,"DF"
"Jakob Sørensen","2020-2021",101,26,13,50,13,50,46,31,33,10,3,27,48,56.3,21,31,4,27,29,75,60,0,52,63,45.2,"DF,MF"
"James Collins","2020-2021",163,30,18,60,12,40,22,15,3,13,6,8,31,25.8,23,25,8,17,10,32,51,0,105,183,36.5,"FW"
"Callum Brittain","2020-2021",187,127,70,55.1,57,44.9,65,45,34,19,12,32,62,51.6,30,59,7,52,33,98,96,1,38,67,36.2,"DF,MF"
"Jack Grimmer","2020-2021",58,20,10,50,10,50,68,39,34,31,3,36,64,56.3,28,43,15,28,53,121,125,1,101,82,55.2,"DF"
"Jack Colback","2020-2021",9,5,5,100,0,0,34,21,15,16,3,11,26,42.3,15,15,7,8,30,64,7,0,13,12,52,"MF"
"Massimo Luongo","2020-2021",5,5,4,80,1,20,29,20,16,13,0,9,23,39.1,14,13,2,11,15,44,15,1,24,14,63.2,"MF"
"Michael Sollbauer","2020-2021",8,9,4,44.4,5,55.6,54,43,41,12,1,33,50,66,17,34,17,17,70,124,100,0,79,70,53,"DF"
"Sam Clucas","2020-2021",45,11,6,54.5,5,45.5,22,16,9,10,3,8,25,32,17,12,4,8,27,49,25,1,28,21,57.1,"MF"
"Danny Hylton","2020-2021",35,10,5,50,5,50,8,1,0,5,3,1,5,20,4,6,1,5,1,9,5,0,10,47,17.5,"FW"
"Richard Stearman","2020-2021",0,3,2,66.7,1,33.3,20,13,15,5,0,11,17,64.7,6,16,14,2,26,46,60,2,64,45,58.7,"DF"
"Jefferson Lerma","2020-2021",58,35,26,74.3,9,25.7,36,19,15,19,2,11,36,30.6,25,35,12,23,42,78,50,0,112,77,59.3,"MF"
"Djed Spence","2020-2021",122,72,31,43.1,41,56.9,30,19,14,13,3,12,20,60,8,27,3,24,27,57,30,0,50,74,40.3,"FW,DF"
"Jack Wilshere","2020-2021",15,13,10,76.9,3,23.1,12,9,9,2,1,4,12,33.3,8,6,1,5,4,16,3,0,7,7,50,"MF"
"Angus MacDonald","2020-2021",12,7,5,71.4,2,28.6,22,19,13,8,1,9,28,32.1,19,41,28,13,47,69,154,1,145,100,59.2,"DF"
"Jacob Davenport","2020-2021",6,6,2,33.3,4,66.7,18,13,6,10,2,9,15,60,6,7,2,5,17,35,12,0,8,15,34.8,"MF"
"Macauley Bonne","2020-2021",77,11,5,45.5,6,54.5,4,1,3,0,1,2,5,40,3,11,2,9,6,10,8,0,61,105,36.7,"FW"
"Tom Barkhuizen","2020-2021",183,51,27,52.9,24,47.1,44,21,18,20,6,19,47,40.4,28,34,2,32,22,66,50,0,48,51,48.5,"FW,DF"
"Herbie Kane","2020-2021",10,5,3,60,2,40,24,14,7,13,4,15,26,57.7,11,6,1,5,13,37,11,1,22,19,53.7,"MF"
"Sam Baldock","2020-2021",32,5,3,60,2,40,7,4,3,3,1,1,2,50,1,4,0,4,3,10,2,0,6,21,22.2,"FW"
"Leandro Bacuna","2020-2021",70,40,20,50,20,50,50,37,21,26,3,25,45,55.6,20,26,2,24,27,77,44,2,13,54,19.4,"DF,MF"
"Lucas João","2020-2021",176,89,56,62.9,33,37.1,10,3,0,5,5,0,11,0,11,15,3,12,9,19,29,0,68,116,37,"FW"
"Martin Cranie","2020-2021",25,12,9,75,3,25,36,21,16,14,6,21,36,58.3,15,22,9,13,32,68,50,1,47,36,56.6,"DF"
"Paul Gallagher","2020-2021",10,3,2,66.7,1,33.3,6,4,3,3,0,2,13,15.4,11,7,3,4,8,14,7,0,3,3,50,"MF"
"Shane Long","2020-2021",26,2,1,50,1,50,3,2,0,1,2,2,3,66.7,1,5,0,5,2,5,3,0,11,20,35.5,"FW"
"Joe Allen","2020-2021",55,19,10,52.6,9,47.4,19,6,6,12,1,8,20,40,12,15,0,15,21,40,18,0,18,27,40,"MF"
"Will Hughes","2020-2021",25,16,12,75,4,25,57,28,17,31,9,26,60,43.3,34,34,14,20,37,94,32,0,31,38,44.9,"MF"
"Harry Toffolo","2020-2021",222,40,26,65,14,35,25,15,15,7,3,14,26,53.8,12,30,14,16,60,85,55,0,41,37,52.6,"DF"
"Carel Eiting","2020-2021",49,18,14,77.8,4,22.2,25,13,9,12,4,7,18,38.9,11,21,3,18,12,37,12,0,16,28,36.4,"MF"
"Sam Morsy","2020-2021",22,24,21,87.5,3,12.5,45,29,21,23,1,18,41,43.9,23,31,7,24,35,80,31,1,51,51,50,"MF"
"Kieran Sadlier","2020-2021",23,14,6,42.9,8,57.1,12,9,6,5,1,8,21,38.1,13,6,0,6,3,15,6,0,6,13,31.6,"MF,FW"
"Julian Börner","2020-2021",9,6,5,83.3,1,16.7,35,22,28,5,2,16,28,57.1,12,25,13,12,39,74,105,1,89,61,59.3,"DF"
"Stefan Johansen","2020-2021",33,20,11,55,9,45,24,13,8,12,4,12,34,35.3,22,19,6,13,16,40,8,1,7,14,33.3,"MF"
"Joe Worrall","2020-2021",7,4,3,75,1,25,24,17,18,5,1,15,21,71.4,6,36,27,9,35,59,138,1,68,53,56.2,"DF"
"Matt Bloomfield","2020-2021",16,4,1,25,3,75,13,6,3,8,2,6,13,46.2,7,10,1,9,6,19,11,0,19,25,43.2,"MF,FW"
"Tyler Blackett","2020-2021",32,10,8,80,2,20,12,8,5,6,1,4,14,28.6,10,6,0,6,15,27,18,0,19,24,44.2,"DF"
"Ben Pearson","2020-2021",15,7,6,85.7,1,14.3,31,17,13,14,4,17,36,47.2,19,21,4,17,28,59,18,1,11,13,45.8,"MF"
"Alen Halilović","2020-2021",35,34,23,67.6,11,32.4,7,5,1,4,2,5,12,41.7,7,3,0,3,2,9,3,0,1,13,7.1,"MF,FW"
"James Chester","2020-2021",1,8,8,100,0,0,46,34,29,17,0,23,36,63.9,13,23,16,7,38,84,119,0,71,55,56.3,"DF"
"Ovie Ejaria","2020-2021",205,160,102,63.8,58,36.3,38,25,15,15,8,13,50,26,37,27,1,26,39,77,27,0,31,43,41.9,"FW"
"Brad Potts","2020-2021",137,27,9,33.3,17,63,33,22,10,17,6,11,43,25.6,32,31,4,27,19,52,21,0,52,57,47.7,"MF,FW"
"Zak Vyner","2020-2021",13,16,13,81.3,3,18.8,53,35,29,21,3,19,36,52.8,17,47,31,16,62,115,134,2,62,60,50.8,"DF,MF"
"Pelly Ruddock Mpanzu","2020-2021",120,87,45,51.7,42,48.3,49,25,19,19,11,17,36,47.2,19,34,6,28,24,73,28,0,38,56,40.4,"MF"
"Tom Bradshaw","2020-2021",80,8,8,100,0,0,9,3,3,5,1,2,4,50,2,14,1,13,5,14,11,0,40,92,30.3,"FW,MF"
"Isaac Mbenza","2020-2021",203,29,14,48.3,15,51.7,25,16,11,11,3,9,20,45,11,6,1,5,10,35,11,0,5,17,22.7,"FW"
"Jake Cooper","2020-2021",15,14,11,78.6,3,21.4,45,25,31,13,1,21,36,58.3,15,43,32,11,63,108,186,2,218,69,76,"DF"
"Juninho Bacuna","2020-2021",123,76,38,50,38,50,43,28,15,24,4,22,70,31.4,48,49,3,46,26,69,36,0,31,74,29.5,"MF,FW"
"Andre Wisdom","2020-2021",13,13,10,76.9,3,23.1,27,18,15,11,1,12,20,60,8,26,16,10,39,66,122,1,46,42,52.3,"DF"
"Mason Bennett","2020-2021",149,55,18,32.7,37,67.3,24,16,10,11,3,4,21,19,17,22,4,18,9,33,13,0,108,162,40,"FW,MF"
"Sammy Ameobi","2020-2021",130,85,47,55.3,38,44.7,54,34,16,26,12,25,49,51,24,29,3,26,30,84,25,0,58,82,41.4,"FW,MF"
"Ilias Chair","2020-2021",264,68,48,70.6,20,29.4,37,22,12,8,17,11,41,26.8,30,29,3,26,12,49,8,0,13,41,24.1,"MF,FW"
"Sam Surridge","2020-2021",50,19,5,26.3,14,73.7,11,6,3,3,5,3,5,60,2,8,2,6,3,14,8,0,23,60,27.7,"FW,MF"
"Nahki Wells","2020-2021",219,53,22,41.5,31,58.5,38,21,11,20,7,14,45,31.1,31,27,0,27,18,56,9,0,16,88,15.4,"FW"
"Stewart Downing","2020-2021",13,1,0,0,1,100,7,3,3,3,1,4,8,50,4,2,2,0,8,15,7,0,2,2,50,"MF"
"Jamal Lowe","2020-2021",296,81,43,53.1,38,46.9,38,23,16,8,14,9,36,25,27,27,2,25,10,48,14,0,67,160,29.5,"FW"
"Josh Murphy","2020-2021",72,49,20,40.8,29,59.2,9,5,6,3,0,4,23,17.4,19,23,0,23,6,15,8,0,13,28,31.7,"FW,MF"
"Leo Skiri Østigård","2020-2021",8,4,1,25,3,75,27,18,16,9,2,17,27,63,10,26,19,7,40,67,166,3,190,93,67.1,"DF"
"Uche Ikpeazu","2020-2021",123,56,26,46.4,30,53.6,8,3,2,2,4,2,5,40,3,17,3,14,3,11,17,0,109,172,38.8,"FW"
"John Buckley","2020-2021",40,13,7,53.8,6,46.2,31,20,13,15,3,13,35,37.1,22,14,1,13,8,39,7,0,10,12,45.5,"MF,FW"
"Joost van Aken","2020-2021",2,3,3,100,0,0,19,14,12,7,0,8,12,66.7,4,13,5,8,20,39,43,0,35,29,54.7,"DF"
"Marco Stiepermann","2020-2021",71,23,10,43.5,13,56.5,9,4,2,3,4,4,6,66.7,2,9,3,6,5,14,7,0,5,21,19.2,"MF,FW"
"Jón Daði Böðvarsson","2020-2021",102,23,12,52.2,11,47.8,14,9,1,13,0,2,8,25,6,11,1,10,6,20,8,0,93,147,38.8,"FW"
"Matt Penney","2020-2021",29,18,9,50,9,50,19,11,12,5,2,11,26,42.3,15,13,1,12,16,35,15,0,9,16,36,"DF,MF"
"Korey Smith","2020-2021",76,23,8,34.8,15,65.2,34,19,17,14,3,13,27,48.1,14,23,4,19,13,47,32,0,26,49,34.7,"MF"
"Jason Knight","2020-2021",153,57,32,56.1,25,43.9,65,38,21,33,11,22,79,27.8,57,39,3,36,37,102,27,0,67,77,46.5,"MF,FW"
"Michael Smith","2020-2021",238,34,19,55.9,15,44.1,19,12,4,10,5,5,23,21.7,18,28,2,26,10,29,28,0,306,256,54.4,"FW"
"Harvey Elliott","2020-2021",211,63,36,57.1,27,42.9,22,13,7,11,4,10,35,28.6,25,27,1,26,20,42,15,2,8,28,22.2,"FW,MF"
"Clarke Oduor","2020-2021",30,25,15,60,10,40,15,8,7,7,1,5,12,41.7,7,10,2,8,9,24,15,0,2,11,15.4,"DF,MF"
"Ched Evans","2020-2021",92,22,11,50,11,50,10,7,1,9,0,3,12,25,9,14,3,11,7,17,15,0,89,147,37.7,"FW"
"Ryan Nyambe","2020-2021",181,59,22,37.3,37,62.7,65,46,42,19,4,20,36,55.6,16,40,14,26,46,111,71,0,56,50,52.8,"DF"
"Liam Moore","2020-2021",6,3,3,100,0,0,22,9,15,5,2,11,18,61.1,7,32,25,7,28,50,115,0,84,59,58.7,"DF"
"Ben Gibson","2020-2021",5,12,9,75,3,25,9,7,3,5,1,5,7,71.4,2,19,14,5,43,52,106,0,75,49,60.5,"DF"
"Kamil Jóźwiak","2020-2021",195,101,58,57.4,43,42.6,48,35,21,19,8,20,49,40.8,29,30,0,30,7,55,12,0,32,93,25.6,"FW,MF"
"Sam Field","2020-2021",3,3,3,100,0,0,27,14,13,12,2,11,25,44,14,17,9,8,20,47,26,0,24,14,63.2,"MF"
"Chris Willock","2020-2021",192,65,46,70.8,19,29.2,29,18,11,12,6,10,35,28.6,25,18,0,18,8,37,2,0,10,39,20.4,"MF,FW"
"Andy Yiadom","2020-2021",62,62,39,62.9,23,37.1,34,24,18,11,5,17,30,56.7,13,16,6,10,15,49,42,1,21,23,47.7,"DF"
"Izzy Brown","2020-2021",29,17,10,58.8,7,41.2,18,8,5,11,2,5,11,45.5,6,11,0,11,14,32,6,0,13,16,44.8,"MF"
"Darnell Fisher","2020-2021",43,23,9,39.1,14,60.9,71,48,41,23,7,31,47,66,16,25,11,14,39,110,61,0,34,34,50,"DF"
"Ismaila Sarr","2020-2021",347,146,73,50,73,50,34,25,15,14,5,11,33,33.3,22,23,1,22,21,55,12,0,25,49,33.8,"FW,MF"
"Louie Sibley","2020-2021",67,36,12,33.3,24,66.7,23,15,3,17,3,10,23,43.5,13,14,3,11,4,27,6,0,2,30,6.3,"MF,FW"
"James Bree","2020-2021",86,18,10,55.6,8,44.4,18,11,13,4,1,7,18,38.9,11,16,5,11,13,31,41,0,27,28,49.1,"DF"
"Jarrad Branthwaite","2020-2021",0,5,2,40,3,60,23,11,19,3,1,10,18,55.6,8,11,6,5,23,46,28,1,37,20,64.9,"DF"
"Ryan Yates","2020-2021",39,9,7,77.8,2,22.2,56,35,27,27,2,22,48,45.8,26,32,10,22,37,93,66,1,109,84,56.5,"MF"
"Chris Martin","2020-2021",134,15,1,6.7,14,93.3,13,9,3,9,1,3,10,30,7,11,6,5,8,21,39,0,109,149,42.2,"FW"
"George Pușcaș","2020-2021",52,13,9,69.2,4,30.8,6,4,0,4,2,0,1,0,1,3,0,3,1,7,2,0,28,25,52.8,"FW"
"Lewis Wing","2020-2021",41,30,20,66.7,10,33.3,60,32,22,35,3,22,60,36.7,38,24,4,20,21,81,28,0,34,40,45.9,"MF"
"Filip Krovinović","2020-2021",79,25,16,64,9,36,25,13,6,9,10,6,18,33.3,12,17,0,17,15,40,6,0,23,48,32.4,"MF,FW"
"Andrew Omobamidele","2020-2021",0,2,2,100,0,0,10,5,6,4,0,2,2,100,0,11,8,3,7,17,35,2,12,5,70.6,"DF"
"Lee Wallace","2020-2021",167,20,15,75,5,25,41,28,26,12,3,21,32,65.6,11,16,6,10,18,59,38,1,27,27,50,"DF"
"Nathan Byrne","2020-2021",191,70,45,64.3,25,35.7,66,36,32,31,3,39,70,55.7,31,32,8,24,44,110,72,1,46,81,36.2,"DF,MF"
"George Saville","2020-2021",72,26,17,65.4,9,34.6,66,41,24,32,10,20,47,42.6,27,50,9,41,37,103,40,0,141,158,47.2,"MF"
"Chey Dunkley","2020-2021",1,1,1,100,0,0,6,1,5,1,0,2,7,28.6,5,13,11,2,23,29,42,0,51,33,60.7,"DF"
"Yoann Barbet","2020-2021",21,20,17,85,3,15,46,26,28,17,1,26,47,55.3,21,59,29,30,105,151,215,1,127,103,55.2,"DF"
"Yakou Méïte","2020-2021",118,49,22,44.9,27,55.1,6,5,1,5,0,3,23,13,20,14,1,13,7,13,11,0,57,83,40.7,"FW"
"Rolando Aarons","2020-2021",60,18,7,38.9,11,61.1,18,9,10,4,4,8,12,66.7,4,5,1,4,6,24,3,0,4,5,44.4,"FW,DF"
"Joe Lolley","2020-2021",88,64,36,56.3,28,43.8,23,16,11,6,6,12,36,33.3,24,15,5,10,9,32,14,1,20,12,62.5,"FW,MF"
"Harry Wilson","2020-2021",114,37,16,43.2,21,56.8,28,17,11,13,4,11,60,18.3,49,22,0,22,29,57,14,0,18,41,30.5,"MF,FW"
"Albert Adomah","2020-2021",96,33,20,60.6,13,39.4,25,14,10,10,5,16,31,51.6,15,18,0,18,14,39,12,1,7,24,22.6,"FW,MF"
"Michael Morrison","2020-2021",3,1,0,0,1,100,37,20,26,11,0,18,27,66.7,9,29,20,9,32,69,139,0,132,57,69.8,"DF"
"Robert Dickie","2020-2021",7,24,21,87.5,3,12.5,54,31,36,15,3,29,48,60.4,19,50,32,18,78,132,176,0,206,94,68.7,"DF"
"Barry Douglas","2020-2021",115,34,19,55.9,15,44.1,70,41,46,20,4,33,53,62.3,20,17,2,15,40,110,57,2,65,52,55.6,"DF"
"Callum O'Dowda","2020-2021",66,43,23,53.5,20,46.5,23,13,11,9,3,10,30,33.3,20,12,2,10,5,28,22,0,26,31,45.6,"MF,FW"
"Ben Davies","2020-2021",2,5,4,80,1,20,22,8,13,8,1,9,12,75,3,19,10,9,26,48,83,1,58,33,63.7,"DF"
"Jayson Molumby","2020-2021",22,11,6,54.5,5,45.5,17,12,5,10,2,8,21,38.1,13,6,2,4,5,22,11,0,14,19,42.4,"MF"
"Jacob Brown","2020-2021",205,49,25,51,24,49,20,11,4,11,5,8,25,32,17,38,3,35,6,26,26,0,90,136,39.8,"FW"
"Rhys Norrington-Davies","2020-2021",147,39,20,51.3,19,48.7,53,29,32,17,4,18,33,54.5,15,53,15,38,33,86,48,1,65,56,53.7,"DF"
"Colin Kazim-Richards","2020-2021",109,35,20,57.1,15,42.9,25,16,9,7,9,10,18,55.6,8,19,4,15,3,28,29,0,149,171,46.6,"FW"
"Josh Pask","2020-2021",13,6,3,50,3,50,20,11,10,10,0,8,16,50,8,12,2,10,11,31,32,0,21,15,58.3,"DF"
"Lyndon Dykes","2020-2021",187,36,17,47.2,19,52.8,19,13,4,10,5,8,27,29.6,19,23,1,22,6,25,24,0,202,243,45.4,"FW"
"Scott Hogan","2020-2021",143,28,11,39.3,16,57.1,9,3,0,2,7,5,13,38.5,8,11,0,11,6,15,6,0,37,80,31.6,"FW"
"Lewis Gibson","2020-2021",6,2,1,50,1,50,18,11,16,2,0,7,11,63.6,4,7,2,5,18,36,26,2,23,16,59,"DF"
"Dominic Hyam","2020-2021",6,4,3,75,1,25,52,32,35,17,0,31,56,55.4,25,42,23,19,63,115,204,1,147,112,56.8,"DF"
"Tyrhys Dolan","2020-2021",132,59,30,50.8,29,49.2,12,9,5,3,4,4,16,25,12,13,0,13,9,21,0,0,9,24,27.3,"FW"
"Danny Ward","2020-2021",36,7,3,42.9,4,57.1,8,6,2,5,1,3,6,50,3,8,1,7,1,9,10,0,18,29,38.3,"FW"
"Gaëtan Bong","2020-2021",16,9,6,66.7,3,33.3,10,5,6,4,0,4,8,50,4,5,2,3,15,25,20,0,19,19,50,"DF"
"Marc Guéhi","2020-2021",6,20,18,90,2,10,66,46,37,25,4,30,42,71.4,12,31,14,17,65,131,112,1,128,87,59.5,"DF"
"Richard Keogh","2020-2021",7,4,4,100,0,0,15,8,12,3,0,7,14,50,7,14,11,3,20,35,71,0,84,57,59.6,"DF"
"Callum Paterson","2020-2021",123,31,12,38.7,19,61.3,32,20,15,10,7,10,37,27,27,37,6,31,13,45,55,0,182,234,43.8,"DF,FW"
"Alex Samuel","2020-2021",35,6,1,16.7,5,83.3,3,3,0,2,1,0,6,0,6,6,0,6,4,7,5,0,18,72,20,"FW"
"Cauley Woodrow","2020-2021",279,52,19,36.5,33,63.5,23,9,9,8,6,8,38,21.1,30,32,2,30,12,35,34,0,116,256,31.2,"FW,MF"
"Philip Billing","2020-2021",111,38,24,63.2,14,36.8,42,24,23,17,2,10,34,29.4,24,43,5,38,21,63,34,0,55,47,53.9,"MF"
"Alfie Mawson","2020-2021",1,5,5,100,0,0,17,11,12,5,0,8,9,88.9,1,17,13,4,17,34,51,0,53,23,69.7,"DF"
"Kal Naismith","2020-2021",25,25,17,68,8,32,47,29,35,11,1,30,45,66.7,15,19,10,9,16,63,67,0,48,35,57.8,"DF"
"Morgan Whittaker","2020-2021",71,23,13,56.5,10,43.5,11,6,6,5,0,4,13,30.8,9,2,0,2,3,14,1,0,6,24,20,"FW,DF"
"Jordan Cousins","2020-2021",3,8,5,62.5,3,37.5,17,10,9,5,3,5,12,41.7,7,7,2,5,8,25,9,0,32,21,60.4,"MF"
"Daryl Dike","2020-2021",113,24,9,37.5,15,62.5,6,4,0,3,3,0,2,0,2,11,1,10,1,7,27,0,107,169,38.8,"FW"
"Matty Pearson","2020-2021",14,3,2,66.7,1,33.3,71,42,44,22,5,40,66,60.6,26,39,22,17,65,136,140,0,106,72,59.6,"DF"
"Kazenga LuaLua","2020-2021",58,22,11,50,11,50,5,5,3,1,1,3,9,33.3,6,3,0,3,7,12,2,0,6,15,28.6,"FW,MF"
"Tashan Oakley-Boothe","2020-2021",34,5,4,80,1,20,6,5,1,5,0,1,3,33.3,2,4,1,3,1,7,5,0,4,6,40,"MF,FW"
"Michael Ihiekwe","2020-2021",16,9,6,66.7,3,33.3,57,45,32,23,2,28,44,63.6,16,34,17,17,78,135,175,3,246,145,62.9,"DF"
"Kyle McFadzean","2020-2021",4,2,1,50,1,50,29,18,19,10,0,12,27,44.4,15,41,31,10,47,76,176,2,136,67,67,"DF"
"Diego Rico","2020-2021",100,26,10,38.5,16,61.5,50,31,29,12,9,23,46,50,23,34,9,25,53,103,65,0,23,28,45.1,"DF,MF"
"Gary Gardner","2020-2021",71,28,16,57.1,12,42.9,40,25,13,19,8,18,34,52.9,16,32,11,21,29,69,34,0,97,60,61.8,"MF"
"Freddie Ladapo","2020-2021",146,38,16,42.1,22,57.9,11,5,1,3,7,5,16,31.3,11,12,1,11,8,19,5,0,77,145,34.7,"FW"
"Tom Holmes","2020-2021",41,15,12,80,3,20,44,27,27,13,4,19,44,43.2,25,25,11,14,42,86,105,2,75,71,51.4,"DF"
"Josh Windass","2020-2021",215,58,23,39.7,35,60.3,16,13,4,10,2,8,44,18.2,36,18,5,13,10,26,25,0,33,89,27,"FW,MF"
"Greg Cunningham","2020-2021",22,14,7,50,7,50,26,19,14,10,2,22,33,66.7,11,6,2,4,14,40,24,1,16,11,59.3,"DF"
"Rarmani Edmonds-Green","2020-2021",0,5,5,100,0,0,20,11,14,6,0,11,17,64.7,6,12,6,6,33,53,66,1,42,28,60,"DF"
"David Brooks","2020-2021",156,76,32,42.1,44,57.9,26,13,8,13,5,11,27,40.7,16,18,3,15,14,40,5,0,1,17,5.6,"FW,MF"
"Marvin Johnson","2020-2021",142,48,25,52.1,23,47.9,29,20,14,9,6,11,27,40.7,16,23,2,21,15,44,19,0,21,40,34.4,"FW,MF"
"Joe Bennett","2020-2021",64,28,16,57.1,12,42.9,38,24,22,13,3,21,36,58.3,15,20,7,13,32,70,53,0,46,24,65.7,"DF"
"Adebayo Akinfenwa","2020-2021",65,5,2,40,3,60,4,3,1,1,2,0,1,0,1,2,0,2,0,4,10,0,217,184,54.1,"FW"
"Todd Kane","2020-2021",115,18,5,27.8,13,72.2,22,16,15,4,3,13,23,56.5,10,24,6,18,19,41,69,0,19,32,37.3,"DF"
"Adam Masina","2020-2021",28,15,8,53.3,7,46.7,39,19,25,13,1,15,42,35.7,27,22,7,15,37,76,78,0,69,30,69.7,"DF"
"Hayden Coulson","2020-2021",33,28,10,35.7,18,64.3,9,3,7,2,0,3,11,27.3,8,9,0,9,5,14,3,0,6,17,26.1,"FW,MF"
"Christian Nørgaard","2020-2021",15,10,7,70,3,30,30,20,12,15,3,19,30,63.3,11,18,4,14,19,49,25,0,22,23,48.9,"MF,DF"
"Tomáš Kalas","2020-2021",9,3,3,100,0,0,29,19,23,6,0,17,25,68,8,75,63,12,72,101,210,1,175,61,74.2,"DF"
"Ivan Toney","2020-2021",253,54,23,42.6,31,57.4,28,13,7,9,12,12,26,46.2,14,18,5,13,8,36,38,0,147,154,48.8,"FW"
"Bradley Johnson","2020-2021",22,16,12,75,4,25,38,23,14,18,6,17,36,47.2,19,29,14,15,36,74,30,0,83,50,62.4,"MF"
"Florian Jozefzoon","2020-2021",70,24,11,45.8,13,54.2,5,2,4,1,0,1,10,10,9,9,0,9,7,12,5,0,3,26,10.3,"MF,FW"
"Jack Clarke","2020-2021",38,26,11,42.3,15,57.7,11,6,5,5,1,6,10,60,4,7,1,6,2,13,4,0,3,9,25,"FW,DF"
"Ivan Šunjić","2020-2021",47,18,9,50,9,50,71,45,28,38,5,32,83,38.6,51,36,7,29,45,116,53,0,38,60,38.8,"MF"
"Chuba Akpom","2020-2021",93,20,12,60,8,40,9,3,0,8,1,1,3,33.3,2,6,1,5,1,10,13,0,91,184,33.1,"FW"
"Matthew Olosunde","2020-2021",48,36,16,44.4,20,55.6,64,38,38,24,2,29,54,53.7,25,39,6,33,43,107,40,0,30,32,48.4,"DF"
"Yan Dhanda","2020-2021",66,25,13,52,12,48,9,3,2,5,2,6,15,40,9,5,1,4,5,14,6,0,8,19,29.6,"MF"
"Jamie Lindsay","2020-2021",56,14,5,35.7,9,64.3,63,32,28,26,9,22,54,40.7,32,44,6,38,35,98,28,0,45,71,38.8,"MF"
"Victor Adeboyejo","2020-2021",94,36,16,44.4,20,55.6,13,8,5,3,5,8,18,44.4,10,27,0,27,10,23,7,0,30,90,25,"FW,MF"
"Thomas Sang","2020-2021",14,7,5,71.4,2,28.6,15,9,13,1,1,8,16,50,8,8,2,6,12,27,12,0,7,11,38.9,"DF,MF"
"Famara Diedhiou","2020-2021",121,24,12,50,12,50,11,9,3,3,5,1,9,11.1,8,15,6,9,6,17,33,1,208,164,55.9,"FW"
"Jack Marriott","2020-2021",25,8,4,50,4,50,1,0,0,0,1,0,7,0,7,2,1,1,0,1,7,0,5,27,15.6,"FW"
"Elliot Lee","2020-2021",32,13,7,53.8,6,46.2,7,5,3,3,1,5,11,45.5,6,8,0,8,6,13,5,0,5,7,41.7,"FW,MF"
"Ethan Pinnock","2020-2021",11,6,6,100,0,0,35,22,27,8,0,14,25,56,11,34,27,7,38,73,206,1,200,104,65.8,"DF"
"Kiko Femenía","2020-2021",206,40,25,62.5,15,37.5,48,34,29,14,5,27,39,69.2,12,17,4,13,49,97,47,1,17,28,37.8,"DF"
"Dominic Solanke","2020-2021",225,124,60,48.4,63,50.8,15,5,3,5,7,4,23,17.4,19,17,6,11,2,17,31,0,81,170,32.3,"FW"
"Kyle Naughton","2020-2021",14,12,6,50,6,50,48,30,24,20,4,26,39,66.7,13,23,7,16,36,84,92,1,64,79,44.8,"DF"
"João Pedro","2020-2021",187,115,61,53,54,47,39,21,9,23,7,7,22,31.8,15,19,2,17,17,56,24,0,69,100,40.8,"FW"
"Tommy Smith","2020-2021",129,15,9,60,6,40,45,23,24,20,1,25,49,51,24,29,6,23,34,79,60,1,26,37,41.3,"DF"
"Grant Hanley","2020-2021",6,10,9,90,1,10,38,18,25,10,3,10,28,35.7,18,38,28,10,77,115,213,2,179,73,71,"DF"
"Callum Styles","2020-2021",121,69,32,46.4,37,53.6,114,72,52,41,21,47,96,49,49,62,5,57,52,166,62,1,51,91,35.9,"DF,MF"
"Andy Rinomhota","2020-2021",85,32,22,68.8,10,31.3,80,46,37,39,4,23,45,51.1,22,25,8,17,46,126,49,1,43,65,39.8,"MF"
"Joel Bagan","2020-2021",9,7,4,57.1,3,42.9,13,7,8,4,1,3,6,50,3,9,3,6,4,17,13,0,9,14,39.1,"DF"
"Han-Noah Massengo","2020-2021",19,36,24,66.7,12,33.3,40,20,22,14,4,21,37,56.8,16,21,4,17,21,61,4,1,15,31,32.6,"MF"
"Matty James","2020-2021",49,39,21,53.8,18,46.2,57,36,21,32,4,30,66,45.5,36,23,5,18,41,98,34,0,49,41,54.4,"MF"
"Ryan Woods","2020-2021",11,44,31,70.5,13,29.5,37,24,12,21,4,14,44,31.8,30,25,10,15,32,69,38,3,39,62,38.6,"MF"
"Chris Brunt","2020-2021",3,1,1,100,0,0,14,10,7,7,0,5,17,29.4,12,9,4,5,10,24,13,0,10,4,71.4,"MF"
"Ben Thompson","2020-2021",61,41,22,53.7,19,46.3,15,5,5,9,1,8,15,53.3,7,16,3,13,14,29,7,0,25,46,35.2,"MF"
"David Wheeler","2020-2021",61,9,5,55.6,4,44.4,33,20,13,17,3,12,33,36.4,21,25,3,22,41,74,62,0,167,135,55.3,"MF,FW"
"Admiral Muskwe","2020-2021",48,27,14,51.9,13,48.1,11,4,2,6,3,4,12,33.3,8,12,1,11,0,11,4,0,17,46,27,"FW,MF"
"Gustavo Hamer","2020-2021",68,48,22,45.8,26,54.2,56,40,15,34,7,24,86,27.9,62,46,5,41,58,114,29,2,10,25,28.6,"MF"
"Antoine Semenyo","2020-2021",168,91,48,52.7,43,47.3,55,34,19,26,10,19,59,32.2,40,33,1,32,21,76,32,0,46,93,33.1,"FW,MF"
"Josh Tymon","2020-2021",78,30,14,46.7,16,53.3,26,16,11,12,3,10,30,33.3,20,16,3,13,15,41,18,1,15,27,35.7,"MF,DF"
"Josh Laurent","2020-2021",41,73,42,57.5,31,42.5,91,58,43,40,8,36,94,38.3,58,64,16,48,65,156,56,0,65,55,54.2,"MF"
"Wayne Rooney","2020-2021",41,13,8,61.5,5,38.5,6,4,2,4,0,3,7,42.9,4,4,1,3,2,8,5,0,6,6,50,"MF,FW"
"Arnaut Danjuma","2020-2021",256,128,59,46.1,69,53.9,9,7,4,4,1,3,11,27.3,8,10,0,10,6,15,2,0,8,15,34.8,"FW"
"Mads Juel Andersen","2020-2021",9,12,12,100,0,0,71,54,53,18,0,32,56,57.1,24,40,13,27,113,184,248,2,307,164,65.2,"DF"
"Scott Malone","2020-2021",151,47,28,59.6,19,40.4,72,45,42,24,6,33,65,50.8,32,56,13,43,61,133,52,0,40,22,64.5,"DF,MF"
"Liam Shaw","2020-2021",18,12,7,58.3,5,41.7,14,8,7,5,2,5,20,25,15,19,10,9,8,22,28,0,33,22,60,"MF,DF"
"Danny Batth","2020-2021",2,5,2,40,3,60,18,12,14,3,1,4,9,44.4,5,26,19,7,40,58,142,2,130,56,69.9,"DF"
"Glenn Murray","2020-2021",33,9,3,33.3,6,66.7,6,2,2,4,0,2,11,18.2,9,10,0,10,1,7,11,0,47,65,42,"FW,MF"
"Lloyd Kelly","2020-2021",104,37,23,62.2,14,37.8,45,27,26,15,4,17,25,68,8,26,11,15,30,75,88,1,68,45,60.2,"DF"
"Todd Cantwell","2020-2021",180,87,53,60.9,34,39.1,44,31,14,19,11,20,60,33.3,40,27,0,27,16,60,24,0,3,18,14.3,"FW"
"Dominic Gape","2020-2021",7,1,0,0,1,100,24,15,12,11,1,7,12,58.3,5,8,2,6,25,49,15,0,17,19,47.2,"MF"
"Saman Ghoddos","2020-2021",68,16,10,62.5,6,37.5,31,16,10,15,6,13,29,44.8,16,15,0,15,11,42,10,0,15,27,35.7,"MF,FW"
"Tyreeq Bakinson","2020-2021",28,37,20,54.1,17,45.9,30,17,11,17,2,12,40,30,28,21,9,12,29,59,34,1,40,32,55.6,"MF"
"Liam Kelly","2020-2021",8,10,6,60,4,40,37,20,18,17,2,15,34,44.1,19,20,8,12,27,64,39,0,32,24,57.1,"MF"
"Joey Pelupessy","2020-2021",13,10,8,80,2,20,61,39,35,22,4,14,38,36.8,24,12,1,11,44,105,31,0,25,25,50,"MF"
"Mahlon Romeo","2020-2021",111,67,33,49.3,34,50.7,59,34,35,19,5,21,45,46.7,24,28,9,19,44,103,49,0,39,52,42.9,"DF,MF"
"Jordan Storey","2020-2021",4,3,3,100,0,0,21,13,13,8,0,11,22,50,11,34,20,14,62,83,133,2,160,70,69.6,"DF"
"Conor Hourihane","2020-2021",62,9,3,33.3,6,66.7,18,9,5,12,1,5,13,38.5,8,8,4,4,9,27,16,1,15,16,48.4,"MF"
"Mark Harris","2020-2021",39,5,2,40,3,60,5,3,1,3,1,0,2,0,2,6,1,5,0,5,5,0,7,24,22.6,"FW,MF"
"Ryan Leonard","2020-2021",41,14,9,64.3,5,35.7,52,33,22,27,3,15,32,46.9,17,26,11,15,41,93,45,0,52,52,50,"MF,DF"
"Shaun MacDonald","2020-2021",6,4,2,50,2,50,24,16,9,14,1,9,21,42.9,12,18,9,9,17,41,16,0,32,32,50,"MF"
"Henri Lansbury","2020-2021",2,5,3,60,2,40,21,12,9,10,2,5,20,25,15,10,2,8,22,43,26,0,12,11,52.2,"MF"
"Chris Mepham","2020-2021",9,8,5,62.5,3,37.5,45,29,30,12,3,24,38,63.2,14,14,8,6,37,82,72,2,83,44,65.4,"DF"
"Romal Palmer","2020-2021",17,28,15,53.6,13,46.4,47,26,17,22,8,14,31,45.2,17,30,5,25,25,72,14,0,42,58,42,"MF"
"Alex Pritchard","2020-2021",46,6,3,50,3,50,11,7,3,5,3,5,14,35.7,9,12,2,10,4,15,5,0,5,10,33.3,"MF"
"Niclas Eliasson","2019-2020",194,76,46,60.5,30,39.5,56,25,27,20,9,20,38,52.6,18,21,1,20,16,72,14,0,14,38,26.9,"MF,FW"
"Morgan Fox","2019-2020",48,8,3,37.5,5,62.5,55,37,29,22,4,11,27,40.7,16,26,12,14,35,90,66,0,49,46,51.6,"DF"
"Marcel Ritzmaier","2019-2020",55,5,5,100,0,0,22,16,10,10,2,7,32,21.9,25,13,1,12,6,28,8,0,8,13,38.1,"MF,DF"
"Josh Harrop","2019-2020",88,35,20,57.1,15,42.9,29,17,10,8,11,12,32,37.5,20,19,2,17,14,43,12,0,12,27,30.8,"FW,MF"
"Samba Sow","2019-2020",20,24,16,66.7,8,33.3,84,55,37,36,11,29,65,44.6,36,36,8,28,34,118,30,1,33,32,50.8,"MF"
"Joe Gelhardt","2019-2020",49,31,17,54.8,14,45.2,0,0,0,0,0,0,6,0,6,2,0,2,0,0,0,0,0,15,0,"MF,FW"
"Kieffer Moore","2019-2020",126,27,15,55.6,12,44.4,28,15,3,20,5,5,27,18.5,22,24,2,22,12,40,53,0,295,186,61.3,"FW"
"Aapo Halme","2019-2020",8,10,5,50,5,50,46,28,20,23,3,20,43,46.5,23,31,11,20,40,86,110,1,141,106,57.1,"DF,MF"
"Elliott Bennett","2019-2020",120,13,4,30.8,9,69.2,76,49,45,24,7,21,41,51.2,20,24,7,17,34,110,80,0,64,55,53.8,"DF,MF"
"Bright Osayi-Samuel","2019-2020",279,162,106,65.4,54,33.3,32,19,10,15,7,11,27,40.7,16,18,0,18,14,46,9,0,23,69,25,"FW,MF"
"Jason Pearce","2019-2020",10,4,2,50,2,50,24,18,17,7,0,7,12,58.3,5,46,39,7,28,52,151,2,157,69,69.5,"DF"
"Nick Powell","2019-2020",85,48,26,54.2,22,45.8,57,34,21,25,11,13,48,27.1,35,34,2,32,28,85,24,0,91,92,49.7,"MF,FW"
"Atdhe Nuhiu","2019-2020",95,47,28,59.6,19,40.4,26,18,6,10,10,3,24,12.5,21,13,1,12,3,29,11,0,191,137,58.2,"FW"
"Alfa Semedo","2019-2020",56,24,10,41.7,14,58.3,32,18,16,13,3,13,35,37.1,22,22,4,18,11,43,19,0,45,47,48.9,"MF"
"Lewis O'Brien","2019-2020",110,77,43,55.8,34,44.2,121,69,33,73,15,30,101,29.7,71,64,13,51,45,166,41,0,31,42,42.5,"MF"
"Jonny Howson","2019-2020",87,76,55,72.4,21,27.6,83,52,56,25,2,46,84,54.8,38,40,14,26,62,145,110,2,67,61,52.3,"DF,MF"
"Ryan Shotton","2019-2020",2,11,8,72.7,3,27.3,39,21,24,13,2,20,26,76.9,6,23,20,3,28,67,85,1,59,58,50.4,"DF"
"Sean Morrison","2019-2020",13,18,13,72.2,5,27.8,37,27,26,11,0,14,26,53.8,12,43,31,12,48,85,197,1,240,111,68.4,"DF"
"Charlie Mulgrew","2019-2020",4,7,7,100,0,0,5,4,3,2,0,2,4,50,2,12,9,3,16,21,65,1,40,25,61.5,"DF"
"Osman Kakay","2019-2020",18,16,11,68.8,5,31.3,13,7,10,3,0,7,17,41.2,10,10,3,7,7,20,12,0,13,22,37.1,"DF"
"Josh Magennis","2019-2020",99,15,10,66.7,5,33.3,1,1,0,0,1,0,5,0,5,7,4,3,2,3,13,0,113,134,45.7,"FW"
"Daniel Crowley","2019-2020",101,92,67,72.8,25,27.2,46,28,18,22,6,15,56,26.8,41,33,2,31,8,54,18,0,7,20,25.9,"MF,FW"
"Fran Villalba","2019-2020",74,31,19,61.3,12,38.7,12,5,9,2,1,7,20,35,13,14,1,13,5,17,7,2,4,5,44.4,"MF"
"Mathias Jensen","2019-2020",108,51,36,70.6,15,29.4,30,15,15,13,2,14,44,31.8,30,22,4,18,24,54,17,0,13,17,43.3,"MF"
"Bobby Reid","2019-2020",230,69,39,56.5,30,43.5,52,31,18,26,8,13,39,33.3,26,24,5,19,14,66,17,1,23,43,34.8,"MF"
"Joe Rothwell","2019-2020",75,76,54,71.1,22,28.9,29,19,15,10,4,11,26,42.3,15,15,1,14,24,53,4,0,3,14,17.6,"FW,MF"
"Gavin Whyte","2019-2020",80,33,17,51.5,16,48.5,38,32,21,12,5,19,59,32.2,40,15,0,15,10,48,16,0,5,17,22.7,"FW,MF"
"Sergi Canós","2019-2020",92,46,24,52.2,22,47.8,28,17,13,7,8,7,24,29.2,17,8,0,8,3,31,2,0,2,8,20,"FW,MF"
"Grant Hall","2019-2020",4,6,4,66.7,2,33.3,24,18,14,10,0,11,16,68.8,5,31,27,4,46,70,143,0,130,49,72.6,"DF"
"George Moncur","2019-2020",27,15,11,73.3,4,26.7,9,4,1,7,1,2,6,33.3,4,4,0,4,3,12,1,0,2,1,66.7,"MF,FW"
"Tommy Elphick","2019-2020",0,2,2,100,0,0,7,5,5,2,0,4,8,50,4,13,13,0,26,33,55,2,43,23,65.2,"DF"
"Kyle Edwards","2019-2020",125,53,39,73.6,14,26.4,11,6,6,1,4,3,10,30,7,9,0,9,7,18,5,0,4,8,33.3,"FW"
"Murray Wallace","2019-2020",79,57,32,56.1,25,43.9,72,42,48,22,2,44,75,58.7,31,33,10,23,51,123,98,0,115,84,57.8,"DF,MF"
"Pontus Jansson","2019-2020",2,9,8,88.9,1,11.1,22,16,18,2,2,12,23,52.2,11,28,20,8,39,61,148,1,122,60,67,"DF"
"Emile Smith Rowe","2019-2020",74,50,28,56,22,44,6,3,0,5,1,2,15,13.3,13,5,0,5,11,17,3,0,4,13,23.5,"MF"
"Andrew Hughes","2019-2020",74,16,7,43.8,9,56.3,33,23,19,11,3,15,31,48.4,16,20,10,10,34,67,97,0,165,66,71.4,"DF"
"Kyle Bartley","2019-2020",2,4,1,25,3,75,51,40,38,12,1,18,25,72,7,41,34,7,45,96,172,1,183,73,71.5,"DF"
"Andrew Shinnie","2019-2020",34,17,13,76.5,4,23.5,23,14,13,7,3,9,28,32.1,19,19,5,14,9,32,10,2,16,19,45.7,"MF"
"Steve Mounié","2019-2020",69,14,5,35.7,9,64.3,10,5,2,7,1,3,12,25,9,7,2,5,9,19,16,0,171,131,56.6,"FW"
"Geoff Cameron","2019-2020",15,22,20,90.9,2,9.1,77,43,42,32,3,31,65,47.7,34,38,19,19,35,112,92,3,92,69,57.1,"MF,DF"
"Callum McManaman","2019-2020",55,31,17,54.8,14,45.2,22,14,8,12,2,7,23,30.4,16,9,0,9,6,28,8,0,5,11,31.3,"FW,MF"
"Ezgjan Alioski","2019-2020",186,24,13,54.2,11,45.8,63,36,38,18,7,25,61,41,36,20,0,20,30,93,45,0,46,69,40,"DF,MF"
"Lewis Grabban","2019-2020",185,61,33,54.1,28,45.9,10,5,1,1,8,3,20,15,17,8,0,8,5,15,39,0,33,91,26.6,"FW"
"Tom Edwards","2019-2020",44,19,12,63.2,7,36.8,16,10,8,6,2,7,12,58.3,5,9,3,6,17,33,35,1,26,19,57.8,"DF"
"Patrick Bauer","2019-2020",7,5,4,80,1,20,56,36,36,19,1,19,34,55.9,15,44,28,16,46,102,194,2,244,124,66.3,"DF"
"Dara O'Shea","2019-2020",31,10,5,50,5,50,31,17,25,5,1,11,23,47.8,12,13,6,7,29,60,48,0,83,48,63.4,"DF"
"Wayne Routledge","2019-2020",103,20,14,70,6,30,17,11,6,10,1,7,17,41.2,10,5,0,5,7,24,7,1,17,26,39.5,"FW,MF"
"Sam Vokes","2019-2020",93,8,4,50,4,50,9,7,0,3,6,2,5,40,3,12,3,9,3,12,22,0,203,207,49.5,"FW"
"Anfernee Dijksteel","2019-2020",29,13,6,46.2,7,53.8,25,16,14,10,1,11,21,52.4,10,15,8,7,11,36,26,0,18,25,41.9,"DF"
"Kadeem Harris","2019-2020",240,154,85,55.2,69,44.8,39,24,18,16,5,12,33,36.4,21,38,2,36,18,57,36,1,18,50,26.5,"MF,DF"
"Connor Roberts","2019-2020",191,19,11,57.9,8,42.1,47,25,33,11,3,20,30,66.7,10,30,12,18,37,84,89,2,34,43,44.2,"DF"
"Robbie McKenzie","2019-2020",6,6,2,33.3,4,66.7,11,7,8,2,1,6,13,46.2,7,5,3,2,8,19,35,0,18,12,60,"DF"
"Alan Browne","2019-2020",144,53,28,52.8,25,47.2,79,43,39,31,9,34,86,39.5,52,52,12,40,40,119,56,0,113,137,45.2,"MF,DF"
"Scott Sinclair","2019-2020",48,20,11,55,9,45,6,5,4,2,0,3,12,25,9,9,1,8,2,8,2,0,1,13,7.1,"FW,MF"
"Darragh Lenihan","2019-2020",14,8,7,87.5,1,12.5,35,20,22,12,1,14,24,58.3,10,49,31,18,40,75,168,1,195,113,63.3,"DF"
"Luke Thomas","2019-2020",130,74,44,59.5,30,40.5,77,51,33,27,17,23,67,34.3,44,36,1,35,18,95,9,0,8,21,27.6,"MF,FW"
"Tomer Hemed","2019-2020",61,10,7,70,3,30,9,7,4,3,2,3,9,33.3,6,8,1,7,1,10,10,0,40,78,33.9,"FW"
"Mateusz Klich","2019-2020",324,42,32,76.2,10,23.8,86,53,38,31,17,23,82,28,59,34,2,32,23,109,19,0,30,26,53.6,"MF"
"Yuri Ribeiro","2019-2020",131,43,24,55.8,19,44.2,34,24,23,10,1,17,26,65.4,9,13,5,8,28,62,75,0,48,54,47.1,"DF"
"Ben Wilmot","2019-2020",0,2,2,100,0,0,17,12,15,2,0,8,15,53.3,7,28,21,7,25,42,84,1,64,81,44.1,"DF"
"Tim Ream","2019-2020",0,16,14,87.5,2,12.5,36,16,28,8,0,16,19,84.2,3,42,31,11,31,67,136,4,116,105,52.5,"DF"
"Shaun Williams","2019-2020",15,10,6,60,4,40,60,31,25,31,4,29,68,42.6,39,33,7,26,28,88,53,1,70,47,59.8,"MF"
"Jay Dasilva","2019-2020",61,61,48,78.7,13,21.3,55,29,27,22,6,23,45,51.1,22,17,6,11,25,80,42,1,18,31,36.7,"DF"
"Luke Berry","2019-2020",35,13,8,61.5,5,38.5,20,10,10,5,5,6,19,31.6,13,19,2,17,19,39,26,0,25,47,34.7,"MF"
"Steven Fletcher","2019-2020",115,21,10,47.6,11,52.4,15,11,4,9,2,3,18,16.7,15,17,4,13,9,24,30,0,149,149,50,"FW"
"Gavin Massey","2019-2020",79,26,16,61.5,10,38.5,28,18,9,14,5,10,27,37,17,11,3,8,13,41,19,0,31,43,41.9,"FW,MF"
"Matt Smith","2019-2020",80,8,4,50,4,50,8,7,1,5,2,1,7,14.3,6,10,3,7,1,9,40,0,301,196,60.6,"FW"
"Harry Arter","2019-2020",22,11,8,72.7,3,27.3,48,30,14,26,8,27,56,48.2,29,31,8,23,14,62,15,1,9,12,42.9,"MF"
"Maxime Colin","2019-2020",155,53,35,66,18,34,111,72,49,54,8,48,86,55.8,38,55,14,41,66,177,109,1,62,64,49.2,"DF"
"Daniel Ayala","2019-2020",2,8,6,75,2,25,31,22,20,11,0,12,18,66.7,6,28,16,12,31,62,148,1,94,69,57.7,"DF"
"Chris Gunter","2019-2020",51,7,4,57.1,3,42.9,29,24,14,11,4,14,19,73.7,5,9,5,4,13,42,57,0,10,12,45.5,"DF"
"Bersant Celina","2019-2020",275,86,45,52.3,41,47.7,24,14,7,10,7,12,35,34.3,23,12,1,11,6,30,8,0,15,28,34.9,"FW,MF"
"Liam Lindsay","2019-2020",0,5,5,100,0,0,30,25,11,18,1,15,23,65.2,8,15,7,8,19,49,65,3,80,35,69.6,"DF"
"Rhian Brewster","2019-2020",103,30,16,53.3,14,46.7,13,6,3,4,6,3,9,33.3,6,13,1,12,5,18,5,0,37,59,38.5,"FW"
"Britt Assombalonga","2019-2020",160,43,22,51.2,21,48.8,5,3,0,4,1,1,9,11.1,8,6,3,3,3,8,23,0,68,169,28.7,"FW"
"Sean McLoughlin","2019-2020",0,4,4,100,0,0,10,7,5,5,0,7,11,63.6,4,6,5,1,10,20,36,2,27,15,64.3,"DF"
"Danny Simpson","2019-2020",47,11,6,54.5,5,45.5,36,22,17,17,2,21,40,52.5,19,13,7,6,46,82,57,3,33,33,50,"DF"
"Erhun Oztumer","2019-2020",28,13,12,92.3,1,7.7,8,5,4,4,0,3,8,37.5,5,4,0,4,7,15,4,0,2,8,20,"MF"
"Lewis Travis","2019-2020",38,56,41,73.2,15,26.8,110,65,50,50,10,38,108,35.2,70,56,17,39,46,156,22,1,23,26,46.9,"MF"
"Adam Reach","2019-2020",107,46,20,43.5,26,56.5,40,24,19,15,6,10,47,21.3,37,15,3,12,14,54,23,0,22,45,32.8,"MF,FW"
"Ryan Ledson","2019-2020",3,2,1,50,1,50,17,8,4,12,1,3,15,20,12,11,3,8,16,33,16,0,10,5,66.7,"MF"
"Junior Hoilett","2019-2020",195,69,35,50.7,34,49.3,53,36,18,24,11,17,53,32.1,36,35,4,31,27,80,29,0,22,49,31,"FW"
"Tobias Figueiredo","2019-2020",4,2,2,100,0,0,16,10,14,1,1,8,16,50,8,30,25,5,26,42,185,0,98,71,58,"DF"
"Dan Potts","2019-2020",80,17,9,52.9,8,47.1,43,23,21,19,3,13,26,50,13,43,22,21,36,79,124,1,80,71,53,"DF"
"Chris Solly","2019-2020",38,2,1,50,1,50,15,8,10,5,0,6,15,40,9,8,6,2,20,35,47,0,15,13,53.6,"DF"
"Alex Mowatt","2019-2020",107,58,37,63.8,21,36.2,90,59,35,47,8,33,91,36.3,58,57,12,45,42,132,43,1,48,54,47.1,"MF"
"Toni Leistner","2019-2020",2,7,4,57.1,3,42.9,20,12,15,5,0,5,10,50,5,15,11,4,38,58,108,0,101,43,70.1,"DF"
"João Carvalho","2019-2020",46,35,15,42.9,20,57.1,14,10,6,5,3,5,17,29.4,12,5,0,5,4,18,8,0,5,28,15.2,"MF,FW"
"Tom Lockyer","2019-2020",18,10,7,70,3,30,48,28,33,15,0,21,36,58.3,15,51,33,18,65,113,171,1,151,131,53.5,"DF"
"Joe Ralls","2019-2020",59,23,14,60.9,9,39.1,59,30,26,23,10,12,32,37.5,20,23,4,19,18,77,22,0,36,60,37.5,"MF"
"Tom Eaves","2019-2020",133,26,16,61.5,10,38.5,28,17,4,10,14,6,16,37.5,10,14,4,10,0,28,14,0,133,119,52.8,"FW"
"Stephen Ward","2019-2020",42,5,5,100,0,0,17,9,4,11,2,7,18,38.9,11,11,2,9,16,33,26,0,33,24,57.9,"DF"
"Tyrese Campbell","2019-2020",146,37,14,37.8,23,62.2,11,6,3,7,1,3,14,21.4,11,15,0,15,1,12,11,0,23,64,26.4,"FW"
"Connor Mahoney","2019-2020",87,36,20,55.6,16,44.4,17,11,6,7,4,4,19,21.1,15,17,0,17,21,38,10,0,5,14,26.3,"MF,FW"
"Aleksandar Mitrović","2019-2020",248,69,31,44.9,38,55.1,11,5,5,2,4,5,23,21.7,18,14,2,12,6,17,33,0,181,203,47.1,"FW"
"Lukas Jutkiewicz","2019-2020",224,30,19,63.3,11,36.7,26,16,3,15,8,5,44,11.4,39,35,7,28,12,38,76,1,352,291,54.7,"FW"
"Marc Bola","2019-2020",15,11,7,63.6,4,36.4,11,6,7,4,0,6,11,54.5,5,8,2,6,12,23,26,2,4,10,28.6,"DF"
"Lee Gregory","2019-2020",154,22,10,45.5,12,54.5,15,10,2,12,1,4,19,21.1,15,18,1,17,7,22,19,0,103,156,39.8,"FW"
"Amari'i Bell","2019-2020",89,29,19,65.5,10,34.5,29,19,19,7,3,16,28,57.1,12,21,4,17,23,52,50,0,41,25,62.1,"DF"
"Jordy de Wijs","2019-2020",12,4,4,100,0,0,53,30,30,23,0,17,30,56.7,13,27,18,9,65,118,226,0,146,88,62.4,"DF"
"Kieran Lee","2019-2020",54,13,7,53.8,6,46.2,54,27,24,22,8,20,38,52.6,18,17,2,15,14,68,22,0,25,33,43.1,"MF"
"Garath McCleary","2019-2020",42,13,8,61.5,5,38.5,6,4,1,3,2,1,3,33.3,2,10,0,10,4,10,4,0,14,15,48.3,"MF,FW"
"Corry Evans","2019-2020",10,2,2,100,0,0,21,11,4,14,3,6,23,26.1,17,9,2,7,13,34,22,0,11,12,47.8,"MF"
"Lyle Taylor","2019-2020",162,14,5,35.7,9,64.3,9,3,3,2,4,2,15,13.3,13,9,1,8,8,17,10,0,41,48,46.1,"FW"
"Darnell Furlong","2019-2020",147,30,17,56.7,13,43.3,31,23,16,11,4,15,27,55.6,12,18,7,11,24,55,70,0,90,46,66.2,"DF"
"Mike-Steven Bähre","2019-2020",68,38,23,60.5,15,39.5,49,28,17,23,9,21,62,33.9,41,20,3,17,12,61,10,0,21,22,48.8,"MF"
"George Evans","2019-2020",11,3,3,100,0,0,14,6,6,8,0,5,14,35.7,9,15,9,6,11,25,21,0,21,22,48.8,"MF,DF"
"Aboubakar Kamara","2019-2020",121,42,27,64.3,15,35.7,15,8,8,4,3,5,23,21.7,18,8,0,8,2,17,12,0,18,13,58.1,"FW,MF"
"Lewis Holtby","2019-2020",75,13,5,38.5,8,61.5,35,21,10,14,11,16,32,50,16,15,3,12,4,39,15,0,11,25,30.6,"MF,FW"
"Keane Lewis-Potter","2019-2020",48,9,3,33.3,6,66.7,9,6,5,4,0,2,10,20,8,8,0,8,3,12,3,0,8,11,42.1,"FW,MF"
"Luke Ayling","2019-2020",149,41,33,80.5,8,19.5,66,39,39,20,7,33,65,50.8,32,34,14,20,61,127,77,0,81,72,52.9,"DF"
"Jay Fulton","2019-2020",50,16,12,75,4,25,77,41,28,37,12,20,50,40,30,39,17,22,44,121,39,0,40,37,51.9,"MF"
"Dael Fry","2019-2020",5,8,6,75,2,25,33,28,24,8,1,14,29,48.3,15,29,25,4,35,68,192,0,159,96,62.4,"DF"
"Sam Gallagher","2019-2020",185,48,26,54.2,22,45.8,31,21,11,13,7,14,38,36.8,24,25,4,21,9,40,41,0,194,174,52.7,"FW"
"Joe Williams","2019-2020",46,48,33,68.8,15,31.3,70,42,28,36,6,25,56,44.6,31,39,16,23,27,97,50,1,40,47,46,"MF"
"Tiago Silva","2019-2020",88,65,45,69.2,20,30.8,56,33,27,18,11,14,61,23,47,18,2,16,32,88,30,0,16,49,24.6,"MF,FW"
"Jed Wallace","2019-2020",251,161,92,57.1,69,42.9,76,60,33,29,14,18,80,22.5,62,29,2,27,25,101,20,0,24,38,38.7,"MF,FW"
"Kasey Palmer","2019-2020",38,45,22,48.9,23,51.1,38,23,16,21,1,10,38,26.3,28,15,1,14,9,47,4,1,17,15,53.1,"MF,FW"
"Wes Harding","2019-2020",12,21,9,42.9,12,57.1,9,5,8,1,0,6,8,75,2,7,3,4,18,27,38,1,16,17,48.5,"DF"
"Adam Clayton","2019-2020",7,17,10,58.8,7,41.2,30,18,16,13,1,15,48,31.3,33,14,4,10,20,50,41,3,14,23,37.8,"MF"
"Jackson Irvine","2019-2020",107,27,21,77.8,6,22.2,68,34,27,31,10,21,80,26.3,59,33,5,28,52,120,44,0,69,69,50,"MF,FW"
"Tom Huddlestone","2019-2020",7,4,4,100,0,0,17,8,8,8,1,8,25,32,17,16,5,11,10,27,30,1,15,4,78.9,"MF"
"Max Bird","2019-2020",24,17,12,70.6,5,29.4,30,16,15,14,1,17,28,60.7,11,11,4,7,23,53,25,0,19,20,48.7,"MF"
"Kieran Gibbs","2019-2020",55,7,7,100,0,0,15,9,9,5,1,3,15,20,12,12,4,8,16,31,19,0,8,8,50,"DF"
"Josh Brownhill","2019-2020",77,32,19,59.4,13,40.6,48,27,22,19,7,14,35,40,21,18,9,9,36,84,43,1,51,39,56.7,"MF"
"Michael Dawson","2019-2020",3,2,1,50,1,50,6,4,5,1,0,1,6,16.7,5,14,14,0,11,17,91,0,50,34,59.5,"DF"
"Duane Holmes","2019-2020",107,82,54,65.9,28,34.1,57,40,27,20,10,19,52,36.5,33,22,1,21,19,76,26,1,20,38,34.5,"MF,FW"
"Harlee Dean","2019-2020",23,14,12,85.7,2,14.3,34,20,24,7,3,10,19,52.6,9,31,21,10,62,96,190,1,183,82,69.1,"DF"
"Stephen Kingsley","2019-2020",13,3,2,66.7,1,33.3,15,8,10,3,2,9,13,69.2,4,11,8,3,5,20,28,0,9,5,64.3,"DF"
"Jonny Williams","2019-2020",65,44,28,63.6,16,36.4,23,10,2,16,5,7,23,30.4,16,10,1,9,15,38,10,0,9,43,17.3,"MF,FW"
"Billy Bodin","2019-2020",72,44,21,47.7,23,52.3,16,8,6,7,3,5,13,38.5,8,12,1,11,6,22,9,0,20,40,33.3,"FW,MF"
"Joe Rafferty","2019-2020",57,11,3,27.3,8,72.7,36,24,18,15,3,16,35,45.7,19,19,5,14,35,71,52,1,48,46,51.1,"DF"
"Emiliano Marcondes","2019-2020",68,18,9,50,9,50,27,14,11,14,2,6,15,40,9,13,2,11,11,38,11,0,15,15,50,"MF,FW"
"Conor Townsend","2019-2020",62,25,15,60,10,40,59,42,39,17,3,31,54,57.4,23,18,6,12,33,92,46,0,46,28,62.2,"DF"
"Conor Chaplin","2019-2020",319,40,25,62.5,15,37.5,24,15,11,9,4,3,35,8.6,32,32,0,32,11,35,13,0,34,106,24.3,"FW,MF"
"Kalvin Phillips","2019-2020",31,26,18,69.2,8,30.8,98,61,44,45,9,31,84,36.9,53,44,12,32,51,149,59,1,68,56,54.8,"MF"
"George Friend","2019-2020",13,15,11,73.3,4,26.7,23,13,12,11,0,9,19,47.4,10,16,7,9,26,49,45,0,60,53,53.1,"DF"
"Kristian Pedersen","2019-2020",84,63,44,69.8,19,30.2,109,74,67,33,9,40,67,59.7,27,59,20,39,74,183,126,1,172,112,60.6,"DF"
"Deji Oshilaja","2019-2020",42,11,9,81.8,2,18.2,28,17,17,9,2,9,15,60,6,23,15,8,16,44,55,1,58,45,56.3,"DF,MF"
"Marc Roberts","2019-2020",15,10,6,60,4,40,37,22,30,5,2,15,27,55.6,12,25,18,7,53,90,180,3,236,78,75.2,"DF"
"Ben Purrington","2019-2020",97,33,12,36.4,21,63.6,45,26,26,17,2,24,40,60,16,32,14,18,33,78,63,3,46,45,50.5,"DF"
"Gaetano Berardi","2019-2020",2,3,3,100,0,0,21,9,15,6,0,9,18,50,9,17,9,8,25,46,50,0,34,40,45.9,"DF"
"Ryan Tunnicliffe","2019-2020",75,32,20,62.5,12,37.5,40,27,13,21,6,15,44,34.1,29,39,15,24,36,76,42,2,18,24,42.9,"MF"
"James McClean","2019-2020",223,69,38,55.1,31,44.9,73,43,40,27,6,35,76,46.1,41,35,6,29,20,93,66,0,87,68,56.1,"FW,DF"
"Bradley Dack","2019-2020",96,35,19,54.3,16,45.7,27,19,8,12,7,6,22,27.3,16,14,3,11,6,33,10,0,6,26,18.8,"MF"
"Dujon Sterling","2019-2020",25,6,3,50,3,50,10,6,5,4,1,6,9,66.7,3,8,5,3,23,33,14,0,11,11,50,"DF"
"Trevoh Chalobah","2019-2020",74,56,39,69.6,17,30.4,57,35,24,29,4,28,48,58.3,20,29,7,22,59,116,65,0,59,56,51.3,"MF,DF"
"Ahmed Hegazi","2019-2020",4,7,6,85.7,1,14.3,21,14,13,8,0,7,12,58.3,5,7,7,0,15,36,72,3,62,44,58.5,"DF"
"Henrik Dalsgaard","2019-2020",112,30,21,70,9,30,72,47,51,18,3,43,80,53.8,37,30,10,20,49,121,116,2,97,76,56.1,"DF"
"Jérémie Bela","2019-2020",131,78,35,44.9,43,55.1,27,16,9,13,5,7,17,41.2,10,12,3,9,10,37,13,0,17,31,35.4,"MF,FW"
"Ben Brereton","2019-2020",49,19,8,42.1,11,57.9,3,1,1,1,1,1,9,11.1,8,1,0,1,0,3,2,0,8,19,29.6,"FW,MF"
"Mads Roerslev","2019-2020",53,6,2,33.3,4,66.7,12,6,10,2,0,7,8,87.5,1,5,2,3,5,17,12,0,10,15,40,"DF,MF"
"Andreas Weimann","2019-2020",203,65,38,58.5,27,41.5,30,23,5,19,6,6,27,22.2,21,30,5,25,29,59,26,1,38,66,36.5,"FW,MF"
"Elias Kachunga","2019-2020",198,46,23,50,23,50,38,28,16,17,5,14,45,31.1,31,28,6,22,17,55,30,0,59,81,42.1,"FW,MF"
"Marcus Tavernier","2019-2020",170,83,44,53,39,47,83,45,34,36,13,28,56,50,28,15,3,12,13,96,31,1,30,56,34.9,"MF,FW"
"Glen Rea","2019-2020",4,8,8,100,0,0,18,13,10,7,1,4,14,28.6,10,20,13,7,36,54,42,1,43,39,52.4,"MF"
"Julian Jeanvier","2019-2020",4,5,4,80,1,20,40,28,27,11,2,24,34,70.6,10,20,14,6,30,70,93,1,46,32,59,"DF"
"André Ayew","2019-2020",339,135,87,64.4,48,35.6,71,47,18,42,11,20,65,30.8,45,27,4,23,27,98,63,0,120,204,37,"FW"
"Ryan Tafazolli","2019-2020",2,1,1,100,0,0,8,8,5,2,1,1,3,33.3,2,11,9,2,13,21,69,0,65,25,72.2,"DF"
"Jordan Obita","2019-2020",88,10,2,20,8,80,18,10,10,7,1,4,9,44.4,5,16,5,11,5,23,25,0,33,20,62.3,"DF,MF"
"Michael Hector","2019-2020",6,10,8,80,2,20,28,21,25,2,1,15,35,42.9,20,21,16,5,14,42,97,0,68,35,66,"DF"
"Harold Moukoudi","2019-2020",1,4,2,50,2,50,14,10,9,5,0,8,11,72.7,3,4,1,3,6,20,29,0,14,9,60.9,"DF,MF"
"Jacob Butterfield","2019-2020",4,8,7,87.5,1,12.5,29,18,12,17,0,13,29,44.8,16,9,2,7,12,41,8,0,2,13,13.3,"MF"
"Josh Dasilva","2019-2020",156,85,60,70.6,25,29.4,36,23,14,19,3,10,31,32.3,21,25,5,20,16,52,34,2,7,15,31.8,"MF"
"Tommy Rowe","2019-2020",69,25,13,52,12,48,31,19,13,18,0,11,36,30.6,25,27,11,16,57,88,78,2,39,57,40.6,"DF"
"Curtis Davies","2019-2020",3,6,5,83.3,1,16.7,42,33,27,15,0,25,44,56.8,19,27,23,4,56,98,140,1,158,88,64.2,"DF"
"Jack Hunt","2019-2020",108,32,18,56.3,14,43.8,50,33,27,19,4,21,47,44.7,26,26,13,13,34,84,74,0,29,53,35.4,"DF"
"Josh Scowen","2019-2020",32,4,1,25,3,75,29,14,15,12,2,12,27,44.4,15,16,7,9,10,39,13,0,9,16,36,"MF"
"Joe Rankin-Costello","2019-2020",33,12,6,50,6,50,12,9,4,4,4,4,15,26.7,11,6,2,4,11,23,13,0,12,15,44.4,"DF,FW"
"Shaun Hutchinson","2019-2020",13,5,4,80,1,20,68,36,51,16,1,33,61,54.1,28,44,25,19,82,150,155,1,205,120,63.1,"DF"
"John Swift","2019-2020",116,101,70,69.3,31,30.7,45,36,21,19,5,14,62,22.6,48,28,9,19,44,89,35,0,24,28,46.2,"MF"
"Adama Diakhaby","2019-2020",110,80,41,51.3,39,48.8,23,18,12,8,3,11,26,42.3,15,13,1,12,4,27,8,0,17,23,42.5,"FW,MF"
"Dominic Samuel","2019-2020",39,12,4,33.3,8,66.7,2,1,2,0,0,2,8,25,6,10,0,10,1,3,5,0,11,35,23.9,"FW"
"Dominic Iorfa","2019-2020",12,32,22,68.8,10,31.3,89,60,65,19,5,37,49,75.5,12,50,20,30,52,141,166,2,133,109,55,"DF"
"Josh Onomah","2019-2020",64,44,29,65.9,15,34.1,64,36,28,24,12,28,61,45.9,33,36,10,26,16,80,10,0,27,30,47.4,"MF"
"Alex Pearce","2019-2020",0,4,4,100,0,0,11,5,8,3,0,3,12,25,9,23,20,3,27,38,131,0,89,58,60.5,"DF"
"Jake Bidwell","2019-2020",223,27,10,37,17,63,46,33,26,17,3,23,44,52.3,21,38,18,20,32,78,120,0,93,70,57.1,"DF"
"Stuart Dallas","2019-2020",188,59,25,42.4,34,57.6,97,62,53,37,7,48,84,57.1,36,43,15,28,42,139,61,0,35,52,40.2,"DF,MF"
"Tom Ince","2019-2020",149,84,38,45.2,46,54.8,48,27,23,17,8,11,35,31.4,24,14,4,10,30,78,14,1,13,67,16.3,"FW,MF"
"Jordan Williams","2019-2020",60,49,35,71.4,14,28.6,71,48,44,21,6,33,56,58.9,23,42,13,29,38,109,66,1,40,39,50.6,"DF"
"Adam Armstrong","2019-2020",281,100,40,40,60,60,25,8,5,12,8,7,27,25.9,20,23,2,21,16,41,8,0,10,43,18.9,"FW,MF"
"Bryan Mbeumo","2019-2020",339,71,41,57.7,30,42.3,39,25,15,19,5,10,32,31.3,22,27,0,27,10,49,14,0,20,49,29,"FW"
"Jordan Thompson","2019-2020",6,3,2,66.7,1,33.3,12,8,5,5,2,3,15,20,12,4,3,1,7,19,8,0,8,8,50,"MF,FW"
"Tyler Roberts","2019-2020",95,29,21,72.4,8,27.6,13,7,2,9,2,0,9,0,9,10,0,10,6,19,6,0,9,19,32.1,"MF,FW"
"Taylor Moore","2019-2020",12,7,5,71.4,2,28.6,24,15,13,10,1,9,17,52.9,8,10,8,2,37,61,46,2,29,35,45.3,"DF"
"Daniel Johnson","2019-2020",122,37,23,62.2,14,37.8,54,31,19,31,4,17,44,38.6,27,23,4,19,28,82,16,0,31,42,42.5,"MF"
"Callum Elder","2019-2020",94,23,11,47.8,12,52.2,55,38,33,12,10,26,43,60.5,17,27,8,19,22,77,93,1,75,44,63,"DF"
"Graeme Shinnie","2019-2020",10,14,8,57.1,6,42.9,53,29,20,27,6,19,45,42.2,26,20,8,12,18,71,20,0,16,19,45.7,"MF"
"Nathan Dyer","2019-2020",55,9,4,44.4,5,55.6,5,4,3,2,0,3,11,27.3,8,8,0,8,4,9,4,0,4,6,40,"FW"
"André Green","2019-2020",63,24,10,41.7,14,58.3,4,3,1,2,1,2,3,66.7,1,8,1,7,1,5,2,0,5,42,10.6,"FW,MF"
"Tom McIntyre","2019-2020",1,4,3,75,1,25,18,8,16,1,1,5,8,62.5,3,9,8,1,13,31,56,0,43,30,58.9,"DF"
"Craig Forsyth","2019-2020",47,6,4,66.7,2,33.3,33,15,21,10,2,10,21,47.6,11,16,8,8,31,64,84,2,58,39,59.8,"DF"
"Ben Cabango","2019-2020",1,3,2,66.7,1,33.3,21,15,16,5,0,7,11,63.6,4,10,6,4,27,48,120,0,65,56,53.7,"DF"
"Kevin McDonald","2019-2020",3,2,1,50,1,50,8,5,7,1,0,2,4,50,2,6,4,2,8,16,10,0,6,7,46.2,"MF"
"Marcus Browne","2019-2020",28,16,3,18.8,13,81.3,10,6,3,4,3,3,8,37.5,5,4,0,4,5,15,9,0,5,11,31.3,"FW,MF"
"Jack Robinson","2019-2020",58,6,5,83.3,1,16.7,44,31,31,10,3,18,33,54.5,15,29,6,23,16,60,50,0,39,30,56.5,"DF"
"Tom Clarke","2019-2020",13,2,1,50,1,50,16,11,9,7,0,7,14,50,7,4,1,3,6,22,28,1,25,20,55.6,"DF"
"Ben Williams","2019-2020",36,10,7,70,3,30,40,31,24,9,7,19,33,57.6,14,19,7,12,26,66,62,0,33,43,43.4,"DF"
"Pelé","2019-2020",13,39,33,84.6,6,15.4,50,32,21,26,3,22,47,46.8,25,28,11,17,21,71,53,0,25,22,53.2,"MF"
"Moses Odubajo","2019-2020",39,25,13,52,12,48,47,33,31,14,2,19,39,48.7,20,9,1,8,19,66,25,1,19,27,41.3,"DF"
"Eric Lichaj","2019-2020",56,30,23,76.7,7,23.3,65,37,44,16,5,36,72,50,36,25,7,18,33,98,100,1,40,50,44.4,"DF"
"Jonathan Leko","2019-2020",100,63,27,42.9,36,57.1,17,10,8,5,4,6,18,33.3,12,13,1,12,6,23,6,0,9,40,18.4,"FW,MF"
"Luke Amos","2019-2020",46,35,20,57.1,15,42.9,49,32,23,18,8,14,57,24.6,43,36,6,30,34,83,30,0,32,30,51.6,"MF"
"Will Vaulks","2019-2020",35,7,7,100,0,0,44,26,21,21,2,20,51,39.2,31,27,13,14,23,67,26,0,50,30,62.5,"MF"
"Romaine Sawyers","2019-2020",51,34,23,67.6,11,32.4,57,47,27,23,7,24,71,33.8,47,30,3,27,21,78,17,3,22,10,68.8,"MF"
"Kamohelo Mokotjo","2019-2020",28,5,5,100,0,0,22,12,9,11,2,7,20,35,13,10,2,8,18,40,7,0,8,10,44.4,"MF"
"Ádám Nagy","2019-2020",10,23,15,65.2,8,34.8,31,19,17,13,1,16,35,45.7,19,11,0,11,28,59,15,0,6,16,27.3,"MF"
"Leon Balogun","2019-2020",2,5,5,100,0,0,14,8,10,4,0,6,8,75,2,9,8,1,13,27,46,1,26,22,54.2,"DF"
"Jarrod Bowen","2019-2020",196,98,51,52,47,48,33,22,11,16,6,7,36,19.4,29,14,0,14,19,52,13,0,22,37,37.3,"MF,FW"
"Dominic Ball","2019-2020",21,33,24,72.7,10,30.3,64,37,35,26,3,22,65,33.8,43,30,13,17,25,89,37,0,33,40,45.2,"MF"
"Matt Phillips","2019-2020",197,65,29,44.6,36,55.4,33,24,12,15,6,12,35,34.3,23,37,3,34,11,44,14,0,35,56,38.5,"FW"
"Bruno Martins Indi","2019-2020",30,6,3,50,3,50,26,16,20,5,1,8,19,42.1,11,16,9,7,36,62,71,1,54,72,42.9,"DF"
"Danny Graham","2019-2020",76,7,4,57.1,3,42.9,5,4,0,4,1,1,5,20,4,5,1,4,1,6,16,0,54,71,43.2,"FW"
"Jayden Stockley","2019-2020",82,5,1,20,4,80,4,3,0,1,3,2,4,50,2,1,1,0,1,5,21,0,155,182,46,"FW"
"Leonardo da Silva Lopes","2019-2020",46,59,44,74.6,15,25.4,74,49,44,25,5,26,82,31.7,56,44,10,34,56,130,64,0,40,45,47.1,"MF,DF"
"Tom Lawrence","2019-2020",207,90,48,53.3,42,46.7,53,32,17,28,8,26,84,31,58,37,7,30,28,81,43,0,13,39,25,"FW,MF"
"Seán Maguire","2019-2020",253,69,26,37.7,43,62.3,46,25,15,20,11,12,68,17.6,56,26,2,24,11,57,11,0,64,174,26.9,"FW,MF"
"Chema","2019-2020",10,3,3,100,0,0,13,10,7,6,0,5,10,50,5,5,4,1,10,23,31,0,20,15,57.1,"DF"
"Bambo Diaby","2019-2020",4,13,11,84.6,2,15.4,33,22,24,9,0,16,20,80,4,27,18,9,30,63,97,1,69,65,51.5,"DF"
"Sam Hutchinson","2019-2020",19,9,7,77.8,2,22.2,57,39,25,32,0,10,27,37,17,20,6,14,36,93,41,0,30,22,57.7,"MF,DF"
"Matt Grimes","2019-2020",24,45,37,82.2,8,17.8,130,76,53,64,13,53,103,51.5,50,59,23,36,71,201,64,3,47,58,44.8,"MF"
"Fraizer Campbell","2019-2020",58,23,9,39.1,14,60.9,28,20,3,13,12,4,13,30.8,9,13,6,7,9,37,14,0,31,69,31,"FW"
"Kamil Grosicki","2019-2020",307,80,39,48.8,41,51.3,19,9,10,7,2,11,30,36.7,19,10,1,9,16,35,8,0,11,17,39.3,"FW"
"Rudy Gestede","2019-2020",25,2,1,50,1,50,3,1,0,2,1,0,2,0,2,5,3,2,1,4,13,0,93,69,57.4,"FW"
"Ryan Manning","2019-2020",196,74,37,50,37,50,84,56,57,22,5,38,68,55.9,30,36,11,25,59,143,84,1,61,52,54,"DF"
"George Honeyman","2019-2020",78,26,16,61.5,10,38.5,43,25,19,20,4,10,56,17.9,46,18,3,15,14,57,11,0,12,28,30,"MF,FW"
"Danny Fox","2019-2020",0,2,2,100,0,0,11,9,11,0,0,4,6,66.7,2,9,6,3,8,19,39,0,21,9,70,"DF"
"Marlon Pack","2019-2020",20,21,19,90.5,2,9.5,54,38,24,27,3,19,41,46.3,22,26,14,12,35,89,61,0,97,44,68.8,"MF"
"Carl Jenkinson","2019-2020",26,9,6,66.7,3,33.3,10,7,6,2,2,3,8,37.5,5,3,1,2,6,16,21,1,8,12,40,"DF"
"Sam Winnall","2019-2020",38,2,1,50,1,50,5,5,1,2,2,1,9,11.1,8,1,1,0,0,5,6,0,18,43,29.5,"FW"
"Jon Toral","2019-2020",43,16,11,68.8,5,31.3,16,8,4,9,3,2,14,14.3,12,3,0,3,4,20,1,0,10,13,43.5,"MF,FW"
"Rico Henry","2019-2020",199,59,36,61,23,39,72,53,45,24,3,27,49,55.1,22,47,13,34,48,120,122,1,87,94,48.1,"DF,MF"
"Paddy McNair","2019-2020",105,60,31,51.7,29,48.3,53,29,20,28,5,24,68,35.3,44,18,7,11,17,70,76,0,70,72,49.3,"MF,DF"
"Christopher Schindler","2019-2020",13,5,4,80,1,20,68,45,37,29,2,23,38,60.5,15,44,34,10,50,118,214,1,171,99,63.3,"DF"
"Jamie Paterson","2019-2020",89,54,33,61.1,21,38.9,46,23,19,20,7,16,41,39,25,22,5,17,23,69,18,0,3,24,11.1,"MF,FW"
"Lee Evans","2019-2020",48,15,7,46.7,8,53.3,34,20,12,18,4,16,34,47.1,18,11,5,6,13,47,20,0,24,29,45.3,"MF"
"Borja Bastón","2019-2020",89,7,1,14.3,6,85.7,14,7,3,7,4,1,8,12.5,7,11,3,8,3,17,14,0,38,61,38.4,"FW"
"Jamie Shackleton","2019-2020",33,9,5,55.6,4,44.4,8,4,1,6,1,2,6,33.3,4,4,2,2,1,9,1,0,4,8,33.3,"MF"
"Krystian Bielik","2019-2020",4,30,26,86.7,4,13.3,53,36,31,20,2,24,50,48,26,25,11,14,33,86,47,3,66,37,64.1,"MF,DF"
"Matthew Clarke","2019-2020",8,17,16,94.1,1,5.9,34,18,21,12,1,9,20,45,11,50,34,16,51,85,176,2,147,64,69.7,"DF"
"Martyn Waghorn","2019-2020",202,37,15,40.5,22,59.5,41,22,16,18,7,9,42,21.4,33,19,4,15,18,59,30,0,56,122,31.5,"FW"
"Toby Sibbick","2019-2020",27,27,13,48.1,14,51.9,39,27,31,6,2,12,25,48,13,22,8,14,19,58,26,1,18,19,48.6,"DF,MF"
"Nuno da Costa","2019-2020",27,20,11,55,9,45,12,7,3,8,1,1,8,12.5,7,13,0,13,5,17,1,0,21,15,58.3,"FW,MF"
"Harry Cornick","2019-2020",246,99,48,48.5,51,51.5,33,10,8,16,9,12,41,29.3,29,29,0,29,13,46,9,0,23,93,19.8,"FW,MF"
"Elliot Simoes","2019-2020",51,21,9,42.9,12,57.1,12,6,5,5,2,3,11,27.3,8,8,0,8,5,17,5,0,11,32,25.6,"MF,FW"
"Jonathan Hogg","2019-2020",17,21,17,81,4,19,79,57,26,47,6,28,78,35.9,50,42,16,26,39,118,52,1,61,32,65.6,"MF"
"Liam Palmer","2019-2020",52,15,4,26.7,11,73.3,53,37,34,16,3,28,44,63.6,16,32,9,23,53,106,70,1,21,30,41.2,"DF"
"Mouhamadou-Naby Sarr","2019-2020",11,10,8,80,2,20,21,15,11,8,2,10,17,58.8,7,21,16,5,37,58,106,1,75,38,66.4,"DF"
"Àngel Rangel","2019-2020",36,8,5,62.5,3,37.5,30,19,13,14,3,15,23,65.2,8,12,4,8,21,51,59,0,18,24,42.9,"DF"
"Patrick Bamford","2019-2020",257,29,13,44.8,16,55.2,20,14,2,12,6,8,25,32,17,12,4,8,4,24,30,0,41,88,31.8,"FW"
"Curtis Nelson","2019-2020",3,7,4,57.1,3,42.9,18,13,7,10,1,3,10,30,7,54,47,7,37,55,167,2,161,84,65.7,"DF"
"Barry Bannan","2019-2020",62,54,41,75.9,13,24.1,64,34,33,27,4,25,70,35.7,45,25,5,20,47,111,20,2,7,25,21.9,"MF"
"Sonny Bradley","2019-2020",3,9,4,44.4,5,55.6,47,28,41,4,2,28,43,65.1,15,39,32,7,39,86,195,1,109,67,61.9,"DF"
"James Collins","2019-2020",226,42,27,64.3,15,35.7,43,24,12,19,12,10,52,19.2,42,31,11,20,21,64,90,0,119,231,34,"FW,MF"
"Badou Ndiaye","2019-2020",10,22,16,72.7,6,27.3,39,29,17,20,2,10,28,35.7,18,16,7,9,20,59,12,0,5,10,33.3,"MF"
"Massimo Luongo","2019-2020",56,29,16,55.2,13,44.8,42,28,5,29,8,13,35,37.1,22,12,3,9,12,54,12,0,40,30,57.1,"MF"
"Daniel Batty","2019-2020",24,27,22,81.5,6,22.2,56,30,20,27,9,21,54,38.9,33,22,6,16,29,85,20,2,14,29,32.6,"MF"
"Michael Sollbauer","2019-2020",7,3,2,66.7,1,33.3,37,18,20,16,1,19,30,63.3,11,11,6,5,34,71,71,1,62,53,53.9,"DF"
"Ivan Cavaleiro","2019-2020",397,121,63,52.1,57,47.1,47,29,17,17,13,15,48,31.3,33,46,2,44,29,76,21,0,49,52,48.5,"FW,MF"
"Sam Clucas","2019-2020",123,40,22,55,18,45,89,59,43,41,5,34,84,40.5,50,23,2,21,52,141,41,0,73,54,57.5,"MF"
"Richard Stearman","2019-2020",5,4,2,50,2,50,5,4,2,3,0,3,8,37.5,5,21,15,6,7,12,72,1,58,38,60.4,"DF"
"Florent Hadergjonaj","2019-2020",87,31,13,41.9,18,58.1,26,17,16,9,1,12,27,44.4,15,11,3,8,15,41,32,0,11,14,44,"DF"
"Marc Pugh","2019-2020",73,33,18,54.5,15,45.5,13,7,5,7,1,2,19,10.5,17,10,2,8,11,24,15,1,6,18,25,"FW,MF"
"Kilian Ludewig","2019-2020",54,27,12,44.4,15,55.6,46,24,32,10,4,21,50,42,29,28,5,23,20,66,39,0,16,34,32,"DF"
"Djed Spence","2019-2020",64,36,18,50,18,50,27,16,14,11,2,5,16,31.3,11,20,4,16,17,44,43,0,17,51,25,"DF,FW"
"Jon Gorenc Stanković","2019-2020",3,1,1,100,0,0,9,4,6,3,0,3,10,30,7,10,9,1,18,27,60,0,54,40,57.4,"DF"
"Angus MacDonald","2019-2020",2,3,3,100,0,0,2,1,2,0,0,0,3,0,3,5,3,2,2,4,18,0,20,14,58.8,"DF"
"Macauley Bonne","2019-2020",130,13,6,46.2,7,53.8,8,5,1,4,3,1,17,5.9,16,17,7,10,5,13,35,0,131,216,37.8,"FW"
"Tom Barkhuizen","2019-2020",236,81,40,49.4,41,50.6,36,24,6,19,11,15,43,34.9,28,36,5,31,21,57,37,0,50,89,36,"FW"
"Herbie Kane","2019-2020",9,4,2,50,2,50,8,5,3,2,3,3,11,27.3,8,1,0,1,7,15,4,0,2,2,50,"MF"
"Sam Baldock","2019-2020",65,21,10,47.6,11,52.4,13,9,2,6,5,2,23,8.7,21,8,0,8,2,15,7,0,13,71,15.5,"FW"
"Leandro Bacuna","2019-2020",48,35,21,60,14,40,53,31,24,28,1,31,55,56.4,24,26,8,18,29,82,53,2,25,38,39.7,"MF,DF"
"Lucas João","2019-2020",64,42,27,64.3,15,35.7,14,6,3,8,3,3,7,42.9,4,11,2,9,2,16,7,0,44,57,43.6,"FW,MF"
"Martin Cranie","2019-2020",21,8,6,75,2,25,37,26,22,11,4,17,28,60.7,11,18,10,8,27,64,53,2,34,35,49.3,"DF,MF"
"Paul Gallagher","2019-2020",24,15,10,66.7,5,33.3,48,26,29,18,1,18,60,30,42,26,3,23,30,78,25,0,16,19,45.7,"MF"
"Adam Forshaw","2019-2020",26,7,7,100,0,0,8,5,3,3,2,1,17,5.9,16,3,0,3,1,9,9,0,9,7,56.3,"MF"
"Joe Allen","2019-2020",66,32,19,59.4,13,40.6,83,49,22,52,9,19,51,37.3,32,23,7,16,66,149,30,0,43,60,41.7,"MF"
"Shane Ferguson","2019-2020",62,18,10,55.6,8,44.4,17,10,8,8,1,5,11,45.5,6,19,3,16,12,29,25,0,3,5,37.5,"MF,DF"
"Harry Toffolo","2019-2020",107,33,21,63.6,12,36.4,33,22,19,10,4,14,22,63.6,8,15,5,10,18,51,37,1,22,31,41.5,"DF"
"Patrick Schmidt","2019-2020",24,2,2,100,0,0,1,0,0,1,0,1,4,25,3,2,0,2,1,2,1,0,8,20,28.6,"FW,MF"
"Sam Morsy","2019-2020",21,52,42,80.8,10,19.2,89,59,35,47,7,23,76,30.3,53,64,13,51,52,141,45,1,44,45,49.4,"MF"
"Cameron McGeehan","2019-2020",19,4,0,0,4,100,22,12,8,12,2,9,22,40.9,13,14,0,14,8,30,14,0,20,20,50,"MF"
"Julian Börner","2019-2020",9,14,13,92.9,1,7.1,46,30,31,14,1,15,36,41.7,21,33,15,18,62,108,131,0,167,97,63.3,"DF"
"Ashley Williams","2019-2020",11,5,4,80,1,20,41,28,23,18,0,14,21,66.7,7,44,33,11,72,113,153,2,84,77,52.2,"DF"
"Joe Worrall","2019-2020",9,2,2,100,0,0,31,20,20,11,0,12,23,52.2,11,72,58,14,57,88,249,0,147,84,63.6,"DF"
"Eddie Nketiah","2019-2020",50,12,6,50,6,50,6,3,1,5,0,1,3,33.3,2,3,0,3,1,7,5,0,8,25,24.2,"FW"
"Reece Burke","2019-2020",9,2,1,50,1,50,42,22,31,11,0,12,24,50,12,41,31,10,44,86,178,2,90,62,59.2,"DF"
"Tyler Blackett","2019-2020",40,19,13,68.4,6,31.6,25,13,14,9,2,11,16,68.8,5,7,4,3,15,40,48,1,26,22,54.2,"DF"
"Ben Pearson","2019-2020",33,25,15,60,10,40,66,46,29,34,3,26,57,45.6,31,27,2,25,51,117,57,0,26,24,52,"MF"
"George Lapslie","2019-2020",10,1,1,100,0,0,22,14,19,3,0,8,19,42.1,11,13,5,8,4,26,13,0,10,11,47.6,"MF,FW"
"James Chester","2019-2020",0,5,5,100,0,0,23,16,16,7,0,13,16,81.3,3,6,6,0,17,40,69,0,46,24,65.7,"DF"
"Brad Potts","2019-2020",87,18,12,66.7,6,33.3,25,16,4,16,5,8,24,33.3,16,24,3,21,7,32,12,0,24,38,38.7,"FW,MF"
"Tom Cairney","2019-2020",193,77,46,59.7,31,40.3,48,29,12,30,6,18,45,40,27,34,2,32,19,67,18,1,21,34,38.2,"MF"
"Nathan Collins","2019-2020",3,4,3,75,1,25,10,8,5,5,0,3,7,42.9,4,3,2,1,7,17,27,0,21,13,61.8,"DF"
"Dimitri Cavaré","2019-2020",30,27,18,66.7,9,33.3,20,15,9,9,2,13,31,41.9,18,10,3,7,10,30,25,1,14,12,53.8,"DF,FW"
"Zak Vyner","2019-2020",8,5,5,100,0,0,12,6,6,6,0,4,9,44.4,5,9,5,4,9,21,13,0,8,28,22.2,"DF"
"Pelly Ruddock Mpanzu","2019-2020",79,108,61,56.5,47,43.5,52,23,25,23,4,19,43,44.2,24,38,18,20,56,108,50,1,36,54,40,"MF"
"Tom Bradshaw","2019-2020",190,32,16,50,16,50,20,12,5,6,9,7,29,24.1,22,22,2,20,0,20,19,0,107,267,28.6,"FW"
"Jake Cooper","2019-2020",16,9,6,66.7,3,33.3,34,26,23,6,5,12,26,46.2,14,44,34,10,48,82,220,4,205,55,78.8,"DF"
"Juninho Bacuna","2019-2020",82,123,69,56.1,54,43.9,48,27,20,25,3,30,56,53.6,26,41,2,39,23,71,19,2,18,28,39.1,"MF,FW"
"Andre Wisdom","2019-2020",15,9,8,88.9,1,11.1,19,10,13,5,1,2,6,33.3,4,12,11,1,17,36,55,0,17,17,50,"DF"
"Mason Bennett","2019-2020",55,14,8,57.1,6,42.9,13,9,6,3,4,4,10,40,6,11,0,11,6,19,10,0,19,29,39.6,"FW,MF"
"Sammy Ameobi","2019-2020",205,148,99,66.9,49,33.1,62,32,25,22,15,20,48,41.7,28,41,4,37,13,75,53,0,91,133,40.6,"FW,MF"
"Ilias Chair","2019-2020",172,41,30,73.2,11,26.8,29,22,8,19,2,10,27,37,17,17,0,17,10,39,6,0,7,32,17.9,"MF,FW"
"Joe Garner","2019-2020",45,8,1,12.5,7,87.5,9,6,1,5,3,1,6,16.7,5,9,4,5,1,10,10,0,85,113,42.9,"FW"
"Jaden Brown","2019-2020",28,16,10,62.5,6,37.5,22,17,14,5,3,13,16,81.3,3,15,6,9,2,24,26,0,6,14,30,"DF"
"Lee Peltier","2019-2020",22,6,4,66.7,2,33.3,35,23,21,13,1,11,17,64.7,6,22,14,8,30,65,84,1,65,21,75.6,"DF,MF"
"Joe Bryan","2019-2020",120,50,34,68,16,32,117,77,70,40,7,52,83,62.7,31,32,6,26,49,166,116,1,79,59,57.2,"DF"
"Jazz Richards","2019-2020",21,9,8,88.9,1,11.1,15,11,10,4,1,6,15,40,9,6,5,1,16,31,28,0,21,13,61.8,"DF"
"Charlie Adam","2019-2020",22,22,18,81.8,4,18.2,15,12,9,4,2,6,15,40,9,5,2,3,11,26,13,0,14,14,50,"MF"
"Sam Surridge","2019-2020",59,14,7,50,7,50,2,2,0,0,2,0,11,0,11,9,2,7,1,3,8,0,28,42,40,"FW"
"Matheus Pereira","2019-2020",282,107,65,60.7,42,39.3,42,29,15,17,10,13,63,20.6,50,34,4,30,27,69,17,0,18,42,30,"MF,FW"
"Nahki Wells","2019-2020",232,38,16,42.1,22,57.9,34,22,15,14,5,7,33,21.2,26,31,2,29,7,41,15,1,41,79,34.2,"FW"
"Stewart Downing","2019-2020",127,29,21,72.4,8,27.6,25,13,14,10,1,13,38,34.2,25,21,6,15,34,59,36,0,8,19,29.6,"MF,FW"
"Nathan Baker","2019-2020",4,5,5,100,0,0,26,19,14,11,1,9,21,42.9,12,54,36,18,57,83,179,0,165,93,64,"DF"
"Jamal Lowe","2019-2020",246,79,48,60.8,31,39.2,67,50,22,24,21,13,51,25.5,38,37,5,32,22,89,45,0,38,89,29.9,"FW,MF"
"Josh Murphy","2019-2020",87,45,23,51.1,22,48.9,25,13,16,7,2,11,34,32.4,23,24,0,24,11,36,12,0,9,30,23.1,"FW"
"Anthony Pilkington","2019-2020",51,12,6,50,6,50,14,10,6,8,0,7,16,43.8,9,10,2,8,5,19,6,0,9,20,31,"FW,MF"
"John Buckley","2019-2020",25,22,15,68.2,7,31.8,19,13,7,10,2,10,23,43.5,13,11,2,9,4,23,5,0,2,7,22.2,"MF,FW"
"Dion Sanderson","2019-2020",16,8,6,75,2,25,12,8,6,4,2,4,5,80,1,6,3,3,14,26,26,0,14,10,58.3,"DF"
"Nathaniel Mendez-Laing","2019-2020",119,77,45,58.4,32,41.6,39,24,22,9,8,8,24,33.3,16,17,2,15,21,60,15,0,27,43,38.6,"FW,MF"
"Oghenekaro Etebo","2019-2020",15,22,17,77.3,5,22.7,18,8,9,8,1,7,14,50,7,10,2,8,10,28,8,1,6,7,46.2,"MF"
"Jón Daði Böðvarsson","2019-2020",96,28,11,39.3,17,60.7,22,15,4,12,6,7,14,50,7,8,3,5,7,29,17,0,77,112,40.7,"FW,MF"
"Benik Afobe","2019-2020",56,13,8,61.5,5,38.5,4,2,0,1,3,1,3,33.3,2,4,0,4,1,5,8,0,35,67,34.3,"FW"
"Alessio da Cruz","2019-2020",49,26,15,57.7,11,42.3,7,5,1,3,3,3,7,42.9,4,5,0,5,4,11,7,0,5,25,16.7,"FW,MF"
"Korey Smith","2019-2020",14,20,15,75,5,25,32,18,17,13,2,14,30,46.7,16,18,9,9,20,52,36,0,27,19,58.7,"MF"
"Jason Knight","2019-2020",98,23,11,47.8,12,52.2,34,24,9,21,4,12,37,32.4,25,20,2,18,23,57,15,1,18,30,37.5,"FW,MF"
"Jake Livermore","2019-2020",63,27,19,70.4,8,29.6,99,64,36,52,11,38,89,42.7,51,62,16,46,31,130,47,0,38,40,48.7,"MF"
"Clarke Oduor","2019-2020",41,40,20,50,20,50,28,19,19,8,1,6,19,31.6,13,13,4,9,16,44,35,0,11,13,45.8,"DF"
"Ryan Nyambe","2019-2020",120,60,41,68.3,19,31.7,40,25,24,14,2,15,26,57.7,11,36,13,23,42,82,62,2,36,36,50,"DF"
"Liam Moore","2019-2020",8,11,9,81.8,2,18.2,49,35,33,16,0,27,47,57.4,20,69,50,19,33,82,182,0,125,98,56.1,"DF"
"Chris Willock","2019-2020",59,27,19,70.4,8,29.6,15,9,5,7,3,4,10,40,6,8,1,7,6,21,2,0,5,7,41.7,"FW"
"Andy Yiadom","2019-2020",98,75,48,64,27,36,55,32,30,19,6,17,32,53.1,15,20,11,9,21,76,45,0,41,34,54.7,"DF"
"Alfie Doughty","2019-2020",111,75,38,50.7,37,49.3,36,22,18,14,4,11,40,27.5,29,30,3,27,31,67,37,0,33,27,55,"DF,MF"
"Darnell Fisher","2019-2020",71,20,9,45,11,55,68,40,43,23,2,29,44,65.9,15,27,7,20,34,102,68,0,37,38,49.3,"DF"
"Darren Pratley","2019-2020",36,20,15,75,5,25,62,40,24,32,6,28,52,53.8,24,37,11,26,69,131,77,0,66,46,58.9,"MF,DF"
"Louie Sibley","2019-2020",36,18,12,66.7,6,33.3,13,6,1,9,3,3,16,18.8,13,4,1,3,2,15,4,0,4,10,28.6,"MF,FW"
"Pablo Hernández","2019-2020",244,67,41,61.2,26,38.8,47,30,16,25,6,20,77,26,57,28,2,26,21,68,10,0,5,22,18.5,"MF"
"Derrick Williams","2019-2020",4,5,4,80,1,20,22,16,15,6,1,10,18,55.6,8,19,14,5,29,51,55,1,60,41,59.4,"DF"
"Ryan Yates","2019-2020",26,5,3,60,2,40,18,10,6,11,1,10,18,55.6,8,15,5,10,18,36,32,0,55,41,57.3,"MF"
"Chris Martin","2019-2020",140,11,7,63.6,4,36.4,13,2,2,8,3,3,8,37.5,5,15,6,9,4,17,32,0,95,124,43.4,"FW"
"George Pușcaș","2019-2020",161,44,18,40.9,26,59.1,6,5,2,4,0,1,10,10,9,6,0,6,2,8,16,0,55,103,34.8,"FW"
"Conor Gallagher","2019-2020",210,101,55,54.5,46,45.5,82,38,26,42,14,36,116,31,80,48,7,41,41,123,33,0,25,72,25.8,"MF,FW"
"Lewis Wing","2019-2020",56,40,24,60,16,40,58,38,27,28,3,25,80,31.3,55,28,8,20,31,89,41,1,30,26,53.6,"MF"
"Filip Krovinović","2019-2020",178,44,24,54.5,20,45.5,34,20,10,18,6,11,42,26.2,31,28,1,27,28,62,15,0,30,38,44.1,"MF"
"Lee Wallace","2019-2020",25,4,2,50,2,50,16,12,12,2,2,5,12,41.7,7,5,1,4,15,31,24,0,11,12,47.8,"DF"
"Chuks Aneke","2019-2020",50,23,15,65.2,8,34.8,7,3,0,3,4,1,5,20,4,7,0,7,0,7,13,0,38,46,45.2,"FW,MF"
"Nathan Byrne","2019-2020",138,84,58,69,26,31,63,44,53,9,1,30,71,42.3,41,41,15,26,38,101,104,0,38,57,40,"DF"
"Michael Olise","2019-2020",59,42,28,66.7,14,33.3,20,14,7,12,1,6,20,30,14,14,0,14,12,32,11,0,8,12,40,"MF,FW"
"George Saville","2019-2020",39,33,22,66.7,11,33.3,56,33,21,31,4,16,48,33.3,32,37,17,20,36,92,56,0,51,51,50,"MF"
"Chey Dunkley","2019-2020",1,3,2,66.7,1,33.3,18,12,14,4,0,6,10,60,4,29,24,5,20,38,102,1,102,71,59,"DF"
"Yoann Barbet","2019-2020",4,9,9,100,0,0,28,18,20,8,0,18,24,75,6,33,21,12,62,90,111,1,67,53,55.8,"DF"
"Yakou Méïte","2019-2020",151,59,33,55.9,26,44.1,36,21,19,12,5,8,45,17.8,37,18,1,17,14,50,34,0,159,157,50.3,"FW,MF"
"Aiden O'Brien","2019-2020",44,18,8,44.4,10,55.6,14,8,6,5,3,6,18,33.3,12,2,1,1,9,23,10,0,12,17,41.4,"FW,MF"
"Joe Lolley","2019-2020",218,131,74,56.5,57,43.5,75,44,30,34,11,29,78,37.2,49,37,5,32,24,99,26,0,16,33,32.7,"FW,MF"
"Albert Adomah","2019-2020",99,39,29,74.4,10,25.6,36,18,16,11,9,14,35,40,21,19,3,16,8,44,13,0,10,28,26.3,"FW"
"Michael Morrison","2019-2020",8,2,2,100,0,0,51,35,33,18,0,20,42,47.6,22,75,53,22,44,95,231,4,185,107,63.4,"DF"
"Pedro Pereira","2019-2020",85,27,12,44.4,15,55.6,41,24,24,16,1,24,36,66.7,12,14,6,8,18,59,50,0,31,36,46.3,"DF"
"Aiden McGeady","2019-2020",23,12,5,41.7,7,58.3,11,6,9,1,1,5,12,41.7,7,6,0,6,3,14,7,0,2,3,40,"MF"
"Jacques Maghoma","2019-2020",60,40,14,35,26,65,21,11,6,9,6,5,13,38.5,8,7,0,7,6,27,3,0,5,8,38.5,"MF,FW"
"Callum O'Dowda","2019-2020",82,43,24,55.8,19,44.2,31,19,11,15,5,10,32,31.3,22,19,2,17,19,50,26,1,43,44,49.4,"MF,FW"
"Jayson Molumby","2019-2020",28,28,17,60.7,11,39.3,49,29,16,25,8,18,66,27.3,48,31,6,25,33,82,37,0,47,50,48.5,"MF"
"Jacob Brown","2019-2020",301,79,42,53.2,37,46.8,50,31,24,17,9,15,55,27.3,40,69,10,59,18,68,43,0,160,252,38.8,"FW"
"Danny Ward","2019-2020",66,12,8,66.7,4,33.3,6,5,3,1,2,0,3,0,3,7,1,6,1,7,8,0,64,129,33.2,"FW,MF"
"Marc Guéhi","2019-2020",3,7,5,71.4,2,28.6,11,6,8,3,0,4,9,44.4,5,17,11,6,25,36,58,1,39,40,49.4,"DF"
"Richard Keogh","2019-2020",3,2,1,50,1,50,13,8,11,1,1,5,9,55.6,4,15,12,3,4,17,27,1,26,12,68.4,"DF"
"Callum Paterson","2019-2020",58,10,5,50,5,50,16,12,4,7,5,2,16,12.5,14,9,1,8,3,19,9,0,163,220,42.6,"FW,MF"
"Cauley Woodrow","2019-2020",208,67,38,56.7,29,43.3,27,15,5,16,6,7,43,16.3,36,24,2,22,11,38,20,0,47,138,25.4,"MF,FW"
"Kal Naismith","2019-2020",48,38,20,52.6,18,47.4,49,33,35,10,4,29,44,65.9,15,31,11,20,33,82,87,1,59,54,52.2,"DF,FW"
"Michael Jacobs","2019-2020",87,32,13,40.6,19,59.4,38,18,13,20,5,16,49,32.7,33,15,1,14,17,55,16,0,39,42,48.1,"FW,MF"
"Lucas Boyé","2019-2020",48,44,25,56.8,19,43.2,20,12,6,9,5,5,15,33.3,10,13,2,11,8,28,4,0,7,17,29.2,"FW,MF"
"Jordan Cousins","2019-2020",12,9,6,66.7,3,33.3,33,18,10,21,2,12,32,37.5,20,21,7,14,19,52,16,0,39,14,73.6,"MF"
"Matty Pearson","2019-2020",9,14,8,57.1,6,42.9,51,37,32,16,3,22,46,47.8,24,63,45,18,48,99,188,3,105,110,48.8,"DF"
"Semi Ajayi","2019-2020",7,19,13,68.4,6,31.6,46,35,32,14,0,12,25,48,13,36,26,10,41,87,139,3,157,67,70.1,"DF"
"Kazenga LuaLua","2019-2020",118,85,45,52.9,40,47.1,16,10,6,3,7,5,14,35.7,9,5,0,5,11,27,5,0,22,28,44,"FW"
"Aldo Kalulu","2019-2020",40,13,5,38.5,8,61.5,9,3,3,5,1,3,15,20,12,1,0,1,7,16,1,0,2,14,12.5,"FW"
"Adam Matthews","2019-2020",79,24,13,54.2,11,45.8,40,23,29,10,1,22,38,57.9,16,18,7,11,23,63,76,0,29,35,45.3,"DF"
"David Davis","2019-2020",11,14,9,64.3,5,35.7,45,28,20,22,3,10,41,24.4,31,9,1,8,17,62,22,0,21,22,48.8,"MF"
"Gary Gardner","2019-2020",56,33,25,75.8,8,24.2,49,33,18,25,6,22,37,59.5,15,29,9,20,31,80,49,0,90,66,57.7,"MF"
"Luke Bolton","2019-2020",34,26,13,50,13,50,33,24,26,6,1,19,39,48.7,20,15,4,11,16,49,29,0,7,17,29.2,"DF,MF"
"Conor Masterson","2019-2020",1,3,2,66.7,1,33.3,7,2,5,2,0,3,3,100,0,13,11,2,7,14,55,0,38,28,57.6,"DF"
"Josh Windass","2019-2020",130,32,13,40.6,19,59.4,9,5,3,5,1,3,16,18.8,13,3,1,2,1,10,2,0,14,42,25,"FW,MF"
"Greg Cunningham","2019-2020",35,3,1,33.3,2,66.7,16,12,10,4,2,8,12,66.7,4,8,5,3,9,25,13,1,15,13,53.6,"DF"
"Liam Cooper","2019-2020",2,15,15,100,0,0,54,30,39,14,1,24,44,54.5,20,26,16,10,69,123,115,2,173,117,59.7,"DF"
"Marvin Johnson","2019-2020",145,71,33,46.5,38,53.5,58,37,34,19,5,21,50,42,29,21,3,18,29,87,40,0,31,36,46.3,"DF,FW"
"Joe Bennett","2019-2020",65,33,20,60.6,13,39.4,68,43,39,25,4,29,55,52.7,26,47,18,29,63,131,119,1,71,55,56.3,"DF"
"Todd Kane","2019-2020",97,19,5,26.3,14,73.7,43,27,31,10,2,22,32,68.8,10,28,5,23,22,65,53,1,25,35,41.7,"DF"
"Kenneth Dougall","2019-2020",5,5,2,40,3,60,29,17,10,18,1,10,29,34.5,19,9,3,6,16,45,17,0,12,13,48,"MF"
"Hayden Coulson","2019-2020",95,84,47,56,37,44,51,32,23,22,6,22,59,37.3,37,24,7,17,29,80,45,0,26,32,44.8,"DF,FW"
"Christian Nørgaard","2019-2020",37,20,15,75,5,25,109,73,44,57,8,42,95,44.2,53,49,14,35,72,181,56,1,56,55,50.5,"MF"
"Ben Watson","2019-2020",12,19,15,78.9,4,21.1,104,68,56,42,6,41,127,32.3,86,64,28,36,76,180,70,0,42,47,47.2,"MF"
"Tomáš Kalas","2019-2020",9,4,4,100,0,0,29,18,19,9,1,11,18,61.1,7,43,36,7,37,66,121,1,78,46,62.9,"DF"
"Bradley Johnson","2019-2020",26,17,12,70.6,5,29.4,54,24,21,30,3,20,53,37.7,33,32,6,26,32,86,26,2,73,44,62.4,"MF"
"Florian Jozefzoon","2019-2020",59,10,4,40,6,60,10,4,4,2,4,4,7,57.1,3,3,1,2,2,12,7,0,3,5,37.5,"FW,DF"
"Ivan Šunjić","2019-2020",29,14,12,85.7,2,14.3,99,52,40,48,11,33,70,47.1,37,33,12,21,58,157,54,0,47,40,54,"MF"
"Kerim Mrabti","2019-2020",73,19,12,63.2,7,36.8,7,6,0,6,1,0,5,0,5,1,0,1,4,11,3,0,9,27,25,"FW,MF"
"Lewis Macleod","2019-2020",3,9,3,33.3,6,66.7,34,22,16,15,3,15,35,42.9,20,10,3,7,10,44,21,1,14,9,60.9,"MF"
"Yan Dhanda","2019-2020",41,17,10,58.8,7,41.2,5,1,0,4,1,1,5,20,4,2,0,2,3,8,2,0,5,3,62.5,"MF,FW"
"Famara Diedhiou","2019-2020",152,84,48,57.1,36,42.9,34,15,8,18,8,13,37,35.1,24,28,7,21,13,47,69,0,208,229,47.6,"FW"
"Jack Marriott","2019-2020",78,18,11,61.1,6,33.3,7,4,1,3,3,1,9,11.1,8,9,0,9,2,9,8,0,11,42,20.8,"FW"
"Elliot Lee","2019-2020",30,14,9,64.3,5,35.7,16,10,7,9,0,6,17,35.3,11,5,2,3,9,25,4,0,7,17,29.2,"MF,FW"
"Ethan Pinnock","2019-2020",4,9,8,88.9,1,11.1,48,29,32,15,1,18,28,64.3,10,33,22,11,49,97,184,3,189,96,66.3,"DF"
"Kyle Naughton","2019-2020",39,19,11,57.9,8,42.1,45,28,20,23,2,20,39,51.3,19,27,9,18,43,88,91,0,42,54,43.8,"DF"
"Tommy Smith","2019-2020",85,15,10,66.7,5,33.3,70,45,38,25,7,38,58,65.5,20,20,2,18,36,106,64,0,28,23,54.9,"DF"
"Callum Styles","2019-2020",41,31,20,64.5,11,35.5,22,11,10,7,5,10,23,43.5,13,15,1,14,13,35,9,0,9,18,33.3,"MF,DF"
"Andy Rinomhota","2019-2020",29,39,25,64.1,14,35.9,67,51,30,30,7,20,54,37,34,25,7,18,30,97,34,1,27,43,38.6,"MF"
"Jake Forster-Caskey","2019-2020",32,2,1,50,1,50,11,8,6,5,0,2,8,25,6,7,2,5,8,19,15,0,7,14,33.3,"MF,DF"
"Josh Bowler","2019-2020",84,64,24,37.5,40,62.5,23,15,14,6,3,8,24,33.3,16,7,0,7,5,28,2,0,5,23,17.9,"FW,MF"
"Han-Noah Massengo","2019-2020",21,25,15,60,10,40,35,19,15,20,0,8,30,26.7,22,20,6,14,34,69,14,1,22,39,36.1,"MF"
"Ryan Woods","2019-2020",12,24,16,66.7,8,33.3,23,18,13,8,2,11,30,36.7,19,18,13,5,19,42,18,0,24,35,40.7,"MF"
"Ben Thompson","2019-2020",86,43,24,55.8,19,44.2,33,22,9,19,5,14,40,35,26,21,1,20,20,53,15,0,43,48,47.3,"MF,FW"
"Ashley Fletcher","2019-2020",187,57,22,38.6,35,61.4,34,23,16,9,9,13,33,39.4,20,29,2,27,9,43,28,1,101,155,39.5,"FW"
"Lee Tomlin","2019-2020",106,55,33,60,22,40,18,12,4,10,4,8,38,21.1,30,15,2,13,16,34,9,0,9,49,15.5,"MF"
"Wayne Rooney","2019-2020",47,31,22,71,9,29,14,11,3,9,2,6,24,25,18,8,3,5,10,24,21,2,15,16,48.4,"MF"
"Mads Juel Andersen","2019-2020",4,13,10,76.9,3,23.1,48,26,35,12,1,23,45,51.1,22,35,18,17,101,149,192,4,196,115,63,"DF"
"Scott Malone","2019-2020",58,23,16,69.6,7,30.4,19,13,14,4,1,6,11,54.5,5,9,2,7,16,35,31,1,10,7,58.8,"DF"
"Danny Batth","2019-2020",5,8,5,62.5,3,37.5,41,26,29,12,0,12,22,54.5,10,41,25,16,71,112,220,0,193,93,67.5,"DF"
"Mallik Wilks","2019-2020",135,78,32,41,44,56.4,7,3,3,0,4,1,13,7.7,12,14,2,12,12,19,8,0,66,96,40.7,"FW,MF"
"Albie Morgan","2019-2020",23,4,3,75,1,25,14,9,8,5,1,6,25,24,19,10,1,9,10,24,12,2,4,12,25,"MF,FW"
"George Byers","2019-2020",66,17,12,70.6,5,29.4,58,31,24,28,6,13,41,31.7,28,25,7,18,30,88,18,1,39,57,40.6,"MF"
"Denis Odoi","2019-2020",36,26,20,76.9,5,19.2,40,24,25,10,5,18,36,50,18,33,16,17,34,74,100,0,74,67,52.5,"DF"
"Joey Pelupessy","2019-2020",3,2,2,100,0,0,31,23,16,12,3,13,24,54.2,11,10,4,6,17,48,12,0,16,20,44.4,"MF"
"Omar Richards","2019-2020",93,30,12,40,18,60,71,41,48,21,2,25,45,55.6,20,33,8,25,30,101,57,0,10,19,34.5,"DF"
"David Nugent","2019-2020",76,18,6,33.3,12,66.7,10,6,2,5,3,3,15,20,12,7,0,7,1,11,5,0,72,110,39.6,"FW"
"Mahlon Romeo","2019-2020",142,66,30,45.5,36,54.5,113,76,64,39,10,44,84,52.4,40,35,15,20,29,142,84,0,36,46,43.9,"DF,MF"
"Jordan Storey","2019-2020",0,3,3,100,0,0,8,4,5,3,0,3,8,37.5,5,4,3,1,19,27,44,0,38,17,69.1,"DF"
"Hal Robson-Kanu","2019-2020",207,81,45,55.6,36,44.4,7,4,1,4,2,3,13,23.1,10,8,2,6,3,10,23,0,33,82,28.7,"FW"
"Ryan Leonard","2019-2020",20,5,1,20,4,80,33,20,13,16,4,10,22,45.5,12,14,4,10,16,49,22,0,21,20,51.2,"MF"
"Kevin Stewart","2019-2020",8,30,21,70,9,30,93,55,43,42,8,22,59,37.3,37,30,3,27,47,140,28,0,21,34,38.2,"MF"
"Alex Pritchard","2019-2020",80,31,14,45.2,17,54.8,16,12,6,7,3,3,16,18.8,13,5,1,4,7,23,3,0,1,9,10,"MF,FW"
"Niclas Eliasson","2018-2019",198,46,24,52.2,22,47.8,52,35,19,24,9,21,39,53.8,18,20,1,19,11,63,14,0,21,60,25.9,"MF,FW"
"Onel Hernández","2018-2019",389,147,69,46.9,78,53.1,40,25,12,19,9,9,36,25,27,36,2,34,18,58,21,1,22,64,25.6,"FW"
"Morgan Fox","2018-2019",56,11,7,63.6,4,36.4,39,20,25,13,1,10,21,47.6,11,25,10,15,27,66,64,1,65,47,58,"DF"
"Elliott Bennett","2018-2019",154,28,20,71.4,8,28.6,113,65,54,46,13,33,79,41.8,46,58,13,45,53,166,84,2,49,60,45,"DF,FW"
"Bright Osayi-Samuel","2018-2019",91,56,30,53.6,26,46.4,13,8,4,4,5,2,7,28.6,5,5,0,5,5,18,4,0,10,35,22.2,"MF,FW"
"Nick Powell","2018-2019",108,30,13,43.3,17,56.7,32,18,3,19,10,5,23,21.7,18,30,2,28,12,44,20,0,79,122,39.3,"MF,FW"
"Atdhe Nuhiu","2018-2019",100,45,20,44.4,25,55.6,21,11,3,11,7,6,19,31.6,13,13,1,12,2,23,36,0,156,157,49.8,"FW"
"Freddie Sears","2018-2019",138,25,9,36,16,64,21,11,10,7,4,8,32,25,24,16,3,13,8,29,7,0,4,32,11.1,"FW,MF"
"Teemu Pukki","2018-2019",328,60,30,50,30,50,21,14,3,9,9,5,30,16.7,25,16,2,14,10,31,12,0,9,58,13.4,"FW,MF"
"Janoi Donacien","2018-2019",12,1,1,100,0,0,25,18,19,5,1,11,17,64.7,6,10,1,9,4,29,34,0,25,16,61,"DF"
"Jonny Howson","2018-2019",174,94,53,56.4,40,42.6,53,31,22,24,7,21,48,43.8,27,54,5,49,17,70,68,1,51,49,51,"MF,DF"
"Ryan Shotton","2018-2019",75,21,15,71.4,6,28.6,62,38,33,24,5,21,46,45.7,25,46,23,23,46,108,140,3,142,65,68.6,"DF"
"George Boyd","2018-2019",53,12,5,41.7,7,58.3,36,14,12,17,7,10,29,34.5,19,15,1,14,7,43,22,0,17,38,30.9,"MF,FW"
"Charlie Mulgrew","2018-2019",2,7,7,100,0,0,25,19,17,7,1,8,14,57.1,6,25,23,2,34,59,129,1,88,49,64.2,"DF"
"Josh Magennis","2018-2019",148,23,8,34.8,15,65.2,9,5,0,6,3,1,8,12.5,7,15,6,9,3,12,61,0,364,368,49.7,"FW"
"Lukas Nmecha","2018-2019",192,69,37,53.6,32,46.4,15,5,6,5,4,6,16,37.5,10,17,2,15,12,27,22,0,63,136,31.7,"FW,MF"
"John Lundstram","2018-2019",21,2,0,0,2,100,11,8,5,5,1,5,13,38.5,8,7,1,6,9,20,4,0,3,2,60,"MF"
"Matthew Pennington","2018-2019",18,11,6,54.5,5,45.5,52,36,31,18,3,21,38,55.3,17,45,28,17,80,132,181,4,139,89,61,"DF"
"Joe Rothwell","2018-2019",75,68,49,72.1,19,27.9,28,16,18,9,1,10,19,52.6,9,17,2,15,12,40,10,0,5,10,33.3,"FW,MF"
"Craig Bryson","2018-2019",62,14,11,78.6,3,21.4,35,22,8,22,5,9,47,19.1,38,25,5,20,34,69,24,0,40,42,48.8,"MF"
"Craig Gardner","2018-2019",14,17,12,70.6,5,29.4,25,18,10,12,3,5,22,22.7,17,11,1,10,12,37,13,0,28,16,63.6,"MF"
"Sergi Canós","2018-2019",236,101,50,49.5,51,50.5,41,25,12,16,13,12,40,30,28,35,0,35,13,54,17,0,23,49,31.9,"FW,MF"
"Reece James","2018-2019",115,62,47,75.8,15,24.2,94,53,49,39,6,40,61,65.6,21,45,15,30,41,135,118,0,82,77,51.6,"DF,MF"
"Samuel Sáiz","2018-2019",126,46,28,60.9,18,39.1,8,5,1,7,0,2,8,25,6,15,0,15,3,11,2,0,7,21,25,"MF"
"Joel Asoro","2018-2019",40,26,9,34.6,17,65.4,8,4,4,3,1,0,3,0,3,2,1,1,3,11,2,0,6,7,46.2,"FW,MF"
"Tommy Elphick","2018-2019",3,3,2,66.7,1,33.3,21,15,15,6,0,10,14,71.4,4,40,30,10,36,57,153,3,137,84,62,"DF"
"Mario Vrančić","2018-2019",44,20,16,80,4,20,54,31,24,24,6,23,43,53.5,20,14,3,11,17,71,27,0,33,45,42.3,"MF"
"Murray Wallace","2018-2019",12,6,2,33.3,4,66.7,24,15,17,6,1,14,18,77.8,4,17,7,10,23,47,70,0,64,38,62.7,"DF"
"Pontus Jansson","2018-2019",21,19,13,68.4,6,31.6,95,65,74,21,0,48,72,66.7,24,56,38,18,90,185,171,2,188,129,59.3,"DF"
"Conor McLaughlin","2018-2019",8,2,0,0,2,100,17,12,10,6,1,8,11,72.7,3,7,1,6,8,25,16,0,9,14,39.1,"DF"
"Enda Stevens","2018-2019",274,61,38,62.3,23,37.7,112,74,57,45,10,56,90,62.2,34,68,9,59,60,172,161,0,83,71,53.9,"DF"
"Andrew Hughes","2018-2019",84,18,12,66.7,6,33.3,43,26,30,13,0,23,40,57.5,17,31,12,19,33,76,144,0,174,85,67.2,"DF"
"Kyle Bartley","2018-2019",6,11,7,63.6,4,36.4,43,26,26,17,0,15,24,62.5,9,24,16,8,36,79,107,0,106,49,68.4,"DF"
"Collin Quaner","2018-2019",86,26,13,50,13,50,7,5,1,5,1,1,9,11.1,8,12,1,11,4,11,4,0,28,88,24.1,"FW"
"Geoff Cameron","2018-2019",3,6,3,50,3,50,43,24,22,20,1,12,33,36.4,21,15,6,9,33,76,50,0,55,24,69.6,"MF,DF"
"Grant Ward","2018-2019",53,16,7,43.8,9,56.3,16,14,9,6,1,2,10,20,8,12,0,12,8,24,9,0,13,28,31.7,"FW,MF"
"Callum McManaman","2018-2019",49,21,13,61.9,8,38.1,6,5,3,2,1,0,2,0,2,3,0,3,1,7,2,0,3,7,30,"FW,MF"
"Ezgjan Alioski","2018-2019",391,29,9,31,20,69,98,55,44,42,12,32,77,41.6,45,58,1,57,25,123,52,1,76,123,38.2,"MF,DF"
"Lewis Grabban","2018-2019",214,38,24,63.2,14,36.8,13,7,2,5,6,3,14,21.4,11,15,2,13,5,18,33,0,25,89,21.9,"FW"
"Luke Chambers","2018-2019",7,5,5,100,0,0,57,32,44,12,1,32,49,65.3,17,44,29,15,46,103,194,4,167,90,65,"DF"
"Chris Basham","2018-2019",121,46,24,52.2,22,47.8,81,46,53,21,7,33,66,50,33,38,15,23,72,153,150,0,115,99,53.7,"DF,MF"
"Lewis Baker","2018-2019",22,26,18,69.2,8,30.8,26,13,8,15,3,11,35,31.4,24,23,11,12,14,40,38,0,12,17,41.4,"MF"
"Tom Edwards","2018-2019",62,33,17,51.5,16,48.5,45,32,30,11,4,22,35,62.9,13,15,6,9,27,72,81,0,36,22,62.1,"DF"
"Sam Byram","2018-2019",11,3,1,33.3,2,66.7,19,11,16,3,0,11,17,64.7,6,4,1,3,14,33,25,0,13,11,54.2,"DF,MF"
"Wayne Routledge","2018-2019",187,42,23,54.8,19,45.2,24,14,6,10,8,7,21,33.3,14,13,2,11,7,31,10,0,11,31,26.2,"FW,MF"
"Sam Vokes","2018-2019",39,2,1,50,1,50,3,1,0,1,2,1,4,25,3,4,1,3,1,4,17,0,85,75,53.1,"FW"
"Kyle Vassell","2018-2019",60,18,5,27.8,13,72.2,9,3,4,3,2,1,6,16.7,5,10,0,10,3,12,10,0,23,35,39.7,"FW,MF"
"Matty Taylor","2018-2019",107,13,5,38.5,8,61.5,12,7,2,8,2,3,16,18.8,13,9,1,8,1,13,6,0,31,91,25.4,"FW"
"Jonathan Grounds","2018-2019",13,5,4,80,1,20,11,5,7,2,2,4,20,20,16,13,6,7,25,36,58,2,28,12,70,"DF"
"James Morrison","2018-2019",38,10,9,90,1,10,20,11,6,14,0,6,20,30,14,14,1,13,12,32,9,0,8,7,53.3,"MF"
"Paweł Wszołek","2018-2019",185,16,9,56.3,7,43.8,62,36,40,17,5,18,33,54.5,15,17,2,15,29,91,37,0,93,135,40.8,"MF,FW"
"Cuco Martina","2018-2019",138,6,3,50,3,50,27,15,15,9,3,11,20,55,9,23,8,15,15,42,45,1,14,30,31.8,"DF"
"Matty Cash","2018-2019",180,82,39,47.6,42,51.2,59,38,21,25,13,22,50,44,28,63,6,57,27,86,45,0,62,105,37.1,"FW,MF"
"Louis Moult","2018-2019",79,10,2,20,8,80,14,11,4,9,1,3,9,33.3,6,12,1,11,2,16,7,0,48,95,33.6,"FW"
"Gary Roberts","2018-2019",49,22,9,40.9,13,59.1,14,9,6,5,3,5,25,20,20,8,0,8,2,16,8,0,2,16,11.1,"MF"
"Connor Roberts","2018-2019",281,31,21,67.7,10,32.3,76,41,44,23,9,25,42,59.5,17,70,17,53,47,123,122,1,39,49,44.3,"DF"
"Robbie McKenzie","2018-2019",7,4,4,100,0,0,11,8,9,2,0,7,12,58.3,5,9,6,3,15,26,79,0,33,40,45.2,"DF"
"Saido Berahino","2018-2019",98,25,16,64,9,36,15,10,6,8,1,1,8,12.5,7,9,0,9,2,17,10,0,19,41,31.7,"FW"
"Alan Browne","2018-2019",137,50,27,54,23,46,49,35,22,22,5,18,49,36.7,31,53,15,38,26,75,60,0,117,147,44.3,"MF"
"Mike van der Hoorn","2018-2019",8,11,9,81.8,2,18.2,57,43,41,14,2,22,34,64.7,12,45,30,15,49,106,254,1,147,78,65.3,"DF"
"Markus Henriksen","2018-2019",58,16,13,81.3,3,18.8,88,59,25,58,5,33,57,57.9,24,48,14,34,59,147,93,1,124,97,56.1,"MF"
"Daniel Pudil","2018-2019",4,2,0,0,2,100,14,9,8,5,1,6,9,66.7,3,15,9,6,17,31,46,1,27,19,58.7,"DF"
"Darragh Lenihan","2018-2019",5,5,4,80,1,20,44,29,30,14,0,16,30,53.3,14,51,35,16,48,92,187,2,209,103,67,"DF"
"Craig Noone","2018-2019",153,88,43,48.9,45,51.1,60,34,31,24,5,19,71,26.8,52,28,5,23,21,81,31,0,26,51,33.8,"FW,MF"
"Tomer Hemed","2018-2019",100,17,9,52.9,8,47.1,12,7,5,4,3,1,15,6.7,14,14,1,13,1,13,22,0,90,160,36,"FW"
"Mateusz Klich","2018-2019",277,46,32,69.6,14,30.4,78,41,25,37,16,24,58,41.4,34,42,3,39,20,98,26,2,23,28,45.1,"MF"
"Ryan Shawcross","2018-2019",7,9,6,66.7,3,33.3,30,21,21,8,1,14,25,56,11,38,32,6,33,63,198,0,144,84,63.2,"DF"
"Antonee Robinson","2018-2019",98,47,32,68.1,15,31.9,57,32,40,14,3,28,56,50,28,28,4,24,34,91,100,1,48,27,64,"DF"
"Steve Morison","2018-2019",151,14,6,42.9,8,57.1,24,17,6,9,9,5,30,16.7,25,14,0,14,5,29,20,0,179,208,46.3,"FW"
"Shaun Williams","2018-2019",44,12,10,83.3,2,16.7,56,31,28,26,2,24,59,40.7,35,33,11,22,28,84,70,0,71,74,49,"MF"
"Jay Dasilva","2018-2019",114,65,37,56.9,28,43.1,46,27,25,19,2,20,30,66.7,10,16,3,13,22,68,33,1,14,41,25.5,"DF"
"David Wheater","2018-2019",9,4,2,50,2,50,43,27,28,13,2,20,33,60.6,13,52,37,15,53,96,248,2,139,77,64.4,"DF"
"Axel Tuanzebe","2018-2019",9,14,11,78.6,3,21.4,29,15,14,15,0,12,18,66.7,6,24,13,11,23,52,107,2,80,54,59.7,"DF"
"Steven Fletcher","2018-2019",147,43,22,51.2,20,46.5,30,19,8,16,6,6,24,25,18,31,7,24,6,36,42,0,266,233,53.3,"FW"
"Craig Conway","2018-2019",100,12,10,83.3,2,16.7,18,10,7,7,4,7,10,70,3,7,1,6,5,23,7,0,6,20,23.1,"FW,MF"
"Anthony Forde","2018-2019",88,27,9,33.3,18,66.7,23,15,9,8,6,8,23,34.8,15,12,1,11,14,37,16,0,20,37,35.1,"MF"
"Gavin Massey","2018-2019",69,16,7,43.8,9,56.3,19,11,9,8,2,5,19,26.3,14,14,1,13,9,28,14,1,15,31,32.6,"MF,FW"
"Matt Smith","2018-2019",43,9,5,55.6,4,44.4,7,6,1,5,1,1,3,33.3,2,1,1,0,1,8,35,0,194,136,58.8,"FW"
"Christoph Zimmermann","2018-2019",2,2,1,50,1,50,37,27,26,11,0,23,29,79.3,6,40,26,14,42,79,177,1,80,56,58.8,"DF"
"Charlie Lakin","2018-2019",3,5,3,60,2,40,14,7,5,9,0,4,12,33.3,8,4,0,4,3,17,6,0,4,4,50,"MF"
"Alexander Milošević","2018-2019",0,1,1,100,0,0,9,6,7,2,0,3,4,75,1,10,6,4,15,24,72,0,26,29,47.3,"DF"
"Maxime Colin","2018-2019",84,47,32,68.1,15,31.9,94,57,49,34,11,46,78,59,32,57,10,47,66,160,144,0,60,38,61.2,"DF"
"Martin Olsson","2018-2019",58,15,6,40,9,60,18,11,13,4,1,4,7,57.1,3,6,0,6,5,23,22,0,31,20,60.8,"DF,MF"
"Daniel Ayala","2018-2019",11,6,2,33.3,4,66.7,51,35,31,18,2,21,29,72.4,8,44,24,20,45,96,182,2,126,77,62.1,"DF"
"Chris Gunter","2018-2019",67,9,2,22.2,7,77.8,26,14,19,5,2,13,24,54.2,11,24,7,17,16,42,78,0,20,23,46.5,"DF"
"Bersant Celina","2018-2019",214,104,58,55.8,46,44.2,17,10,8,6,3,5,19,26.3,14,10,2,8,8,25,20,2,9,26,25.7,"MF,FW"
"Brandon Barker","2018-2019",54,24,12,50,12,50,5,1,1,3,1,2,10,20,8,6,0,6,3,8,4,0,2,22,8.3,"FW"
"Mark Beevers","2018-2019",15,2,2,100,0,0,41,21,26,15,0,16,27,59.3,11,42,33,9,51,92,249,0,218,76,74.1,"DF"
"Jack O'Connell","2018-2019",56,11,7,63.6,4,36.4,26,13,18,5,3,16,25,64,9,39,27,12,53,79,207,2,197,97,67,"DF"
"Britt Assombalonga","2018-2019",218,49,21,42.9,28,57.1,14,9,1,8,5,2,18,11.1,16,7,3,4,1,15,31,1,43,118,26.7,"FW"
"Erhun Oztumer","2018-2019",45,4,3,75,1,25,4,2,1,2,1,1,6,16.7,5,4,1,3,5,9,2,0,1,25,3.8,"MF"
"Jordan Thorniley","2018-2019",6,3,1,33.3,2,66.7,34,26,20,12,2,15,19,78.9,4,23,8,15,21,55,96,0,49,42,53.8,"DF"
"Clark Robertson","2018-2019",7,3,2,66.7,1,33.3,23,12,18,3,2,9,15,60,6,18,13,5,36,59,136,0,138,82,62.7,"DF"
"Lewis Travis","2018-2019",31,27,16,59.3,10,37,58,41,17,34,7,21,51,41.2,30,33,11,22,22,80,14,0,18,29,38.3,"MF"
"Adam Reach","2018-2019",227,84,39,46.4,45,53.6,44,29,16,19,9,18,59,30.5,41,44,6,38,24,68,50,0,57,51,52.8,"MF,FW"
"Ryan Ledson","2018-2019",8,2,2,100,0,0,30,19,10,18,2,7,20,35,13,23,11,12,29,59,29,1,35,16,68.6,"MF"
"Tobias Figueiredo","2018-2019",2,1,1,100,0,0,13,8,11,2,0,2,4,50,2,12,8,4,15,28,74,0,43,52,45.3,"DF"
"Will Grigg","2018-2019",43,5,2,40,3,60,5,3,3,2,0,1,3,33.3,2,9,1,8,2,7,3,0,24,68,26.1,"FW"
"João Carvalho","2018-2019",168,120,51,42.5,69,57.5,33,26,10,19,4,11,37,29.7,26,25,2,23,9,42,11,1,7,36,16.3,"MF"
"Connor Mahoney","2018-2019",94,54,18,33.3,36,66.7,25,16,10,10,5,9,26,34.6,17,16,2,14,15,40,17,0,8,14,36.4,"MF"
"Lukas Jutkiewicz","2018-2019",262,24,14,58.3,10,41.7,24,11,6,17,1,3,49,6.1,46,54,5,49,16,40,92,0,561,416,57.4,"FW"
"George Baldock","2018-2019",174,23,10,43.5,12,52.2,49,33,26,22,1,19,28,67.9,9,22,5,17,22,71,56,1,31,42,42.5,"DF"
"Lee Gregory","2018-2019",317,50,22,44,27,54,33,23,7,17,9,8,35,22.9,27,48,5,43,13,46,8,0,102,237,30.1,"FW"
"Amari'i Bell","2018-2019",105,69,46,66.7,23,33.3,57,33,39,13,5,29,48,60.4,19,39,10,29,28,85,110,1,97,82,54.2,"DF"
"Callum Connolly","2018-2019",24,5,4,80,1,20,48,31,29,15,4,18,33,54.5,15,21,7,14,20,68,69,0,61,50,55,"MF,DF"
"Jordan Rhodes","2018-2019",65,1,0,0,1,100,4,1,0,2,2,2,11,18.2,9,5,0,5,1,5,16,0,60,97,38.2,"FW"
"Jordy de Wijs","2018-2019",3,3,3,100,0,0,34,17,17,17,0,14,25,56,11,43,21,22,40,74,254,4,173,96,64.3,"DF"
"Rekeem Harper","2018-2019",30,30,20,66.7,10,33.3,7,4,1,4,2,4,14,28.6,10,9,1,8,9,16,10,0,16,17,48.5,"MF"
"Leroy Fer","2018-2019",23,18,15,83.3,3,16.7,40,24,17,19,4,8,21,38.1,13,18,8,10,17,57,18,1,47,19,71.2,"MF"
"Garath McCleary","2018-2019",132,50,27,54,23,46,15,11,5,6,4,4,14,28.6,10,19,3,16,10,25,19,0,30,35,46.2,"FW,MF"
"Alan Judge","2018-2019",198,35,19,54.3,16,45.7,32,17,12,12,8,18,51,35.3,33,35,5,30,17,49,15,1,8,25,24.2,"FW,MF"
"Courtney Baker-Richardson","2018-2019",23,3,2,66.7,1,33.3,1,0,0,0,1,0,1,0,1,5,2,3,2,3,9,0,17,36,32.1,"FW"
"Corry Evans","2018-2019",31,26,19,73.1,7,26.9,87,48,26,48,13,28,69,40.6,41,54,15,39,62,149,53,0,40,65,38.1,"MF"
"Harvey Barnes","2018-2019",208,94,45,47.9,49,52.1,11,7,3,8,0,3,11,27.3,8,14,2,12,4,15,6,0,13,24,35.1,"MF,FW"
"Darnell Furlong","2018-2019",40,8,4,50,4,50,25,20,15,9,1,16,22,72.7,6,19,7,12,30,55,94,1,115,54,68,"DF"
"Luke Ayling","2018-2019",175,42,24,57.1,18,42.9,79,53,45,30,4,36,59,61,23,33,11,22,44,123,66,1,94,61,60.6,"DF"
"John Obi Mikel","2018-2019",13,20,13,65,7,35,37,22,21,13,3,17,39,43.6,22,27,10,17,19,56,26,0,29,25,53.7,"MF"
"Oliver Norwood","2018-2019",37,11,9,81.8,2,18.2,100,48,48,47,5,33,93,35.5,60,34,11,23,74,174,54,3,55,29,65.5,"MF"
"Jay Fulton","2018-2019",44,19,15,78.9,4,21.1,66,37,34,27,5,27,47,57.4,20,31,5,26,24,90,29,1,30,48,38.5,"MF"
"Dael Fry","2018-2019",23,26,17,65.4,9,34.6,33,23,25,8,0,17,27,63,10,19,9,10,24,57,169,0,119,75,61.3,"DF"
"Matt Crooks","2018-2019",32,20,12,60,8,40,15,10,3,8,4,2,14,14.3,12,9,1,8,2,17,6,0,18,22,45,"MF"
"Joe Williams","2018-2019",50,50,33,66,17,34,82,42,31,42,9,23,60,38.3,37,52,18,34,40,122,44,1,30,42,41.7,"MF"
"Jed Wallace","2018-2019",244,136,58,42.6,78,57.4,73,49,24,36,13,25,79,31.6,54,38,1,37,31,104,22,0,41,68,37.6,"MF,FW"
"Kasey Palmer","2018-2019",60,63,42,66.7,21,33.3,38,26,18,16,4,6,22,27.3,16,24,0,24,11,49,17,0,35,45,43.8,"MF"
"Marley Watkins","2018-2019",34,8,8,100,0,0,12,7,6,5,1,3,9,33.3,6,4,0,4,4,16,8,0,17,58,22.7,"MF"
"Wes Harding","2018-2019",24,29,12,41.4,17,58.6,32,18,18,12,2,13,23,56.5,10,22,8,14,29,61,61,0,30,39,43.5,"DF"
"Adam Clayton","2018-2019",15,28,17,60.7,11,39.3,65,38,30,31,4,21,51,41.2,30,39,13,26,48,113,50,1,19,22,46.3,"MF"
"Jackson Irvine","2018-2019",112,43,30,69.8,13,30.2,60,33,18,38,4,16,53,30.2,37,35,2,33,49,109,76,0,168,169,49.9,"MF,FW"
"Tom Huddlestone","2018-2019",19,5,3,60,2,40,33,21,14,18,1,14,28,50,14,16,5,11,21,54,49,1,41,36,53.2,"MF"
"Kieran Gibbs","2018-2019",188,45,19,42.2,26,57.8,44,26,22,19,3,9,28,32.1,19,31,9,22,57,101,94,0,37,47,44,"DF"
"Kenny McLean","2018-2019",45,15,10,66.7,5,33.3,36,22,20,13,3,12,24,50,12,12,4,8,20,56,26,0,50,55,47.6,"MF"
"Joe Newell","2018-2019",104,42,20,47.6,22,52.4,39,23,14,15,10,12,42,28.6,30,23,2,21,14,53,15,1,20,31,39.2,"MF,FW"
"Duane Holmes","2018-2019",80,48,32,66.7,16,33.3,23,15,9,6,8,10,29,34.5,19,18,3,15,19,42,16,1,7,26,21.2,"MF,FW"
"Harlee Dean","2018-2019",23,23,9,39.1,13,56.5,46,31,31,15,0,15,25,60,10,54,25,29,63,109,227,0,242,119,67,"DF"
"Josh McEachran","2018-2019",9,15,13,86.7,2,13.3,48,27,19,27,2,23,44,52.3,21,17,5,12,27,75,18,0,9,11,45,"MF"
"Stephen Kingsley","2018-2019",45,24,17,70.8,7,29.2,36,21,24,12,0,21,29,72.4,8,33,12,21,22,58,91,1,74,57,56.5,"DF"
"Cole Skuse","2018-2019",14,8,7,87.5,1,12.5,39,20,18,21,0,13,33,39.4,20,28,14,14,50,89,65,1,77,41,65.3,"MF"
"Jay Rodriguez","2018-2019",239,74,19,25.7,55,74.3,43,27,12,22,9,12,55,21.8,43,52,6,46,17,60,68,1,82,134,38,"FW"
"Bailey Wright","2018-2019",14,5,1,20,4,80,14,9,9,5,0,8,16,50,8,12,10,2,15,29,41,0,20,17,54.1,"DF"
"Maikel Kieftenbeld","2018-2019",20,22,17,77.3,5,22.7,56,36,15,36,5,17,44,38.6,27,38,3,35,46,102,51,1,31,35,47,"MF"
"Kayden Jackson","2018-2019",144,15,9,60,5,33.3,7,5,0,6,1,2,11,18.2,9,7,0,7,1,8,9,0,36,166,17.8,"FW"
"Joe Rafferty","2018-2019",13,2,0,0,2,100,3,1,3,0,0,2,3,66.7,1,8,3,5,4,7,15,0,7,12,36.8,"DF"
"Emiliano Marcondes","2018-2019",28,4,2,50,2,50,7,4,3,3,1,2,5,40,3,1,0,1,2,9,3,0,1,15,6.3,"MF,FW"
"Conor Townsend","2018-2019",50,16,8,50,8,50,23,13,13,8,2,13,21,61.9,8,12,4,8,13,36,20,1,21,16,56.8,"DF"
"Kalvin Phillips","2018-2019",35,31,23,74.2,8,25.8,111,64,55,49,7,49,94,52.1,45,48,14,34,58,169,109,2,106,86,55.2,"MF,DF"
"George Friend","2018-2019",128,80,27,33.8,53,66.3,61,38,33,19,9,25,36,69.4,11,43,20,23,30,91,121,4,116,73,61.4,"DF"
"James Vaughan","2018-2019",18,2,0,0,2,100,3,1,1,1,1,0,5,0,5,3,1,2,1,4,7,0,75,74,50.3,"FW"
"Kristian Pedersen","2018-2019",34,39,24,61.5,15,38.5,88,55,60,25,3,39,60,65,21,58,19,39,105,193,193,1,128,62,67.4,"DF"
"Gaetano Berardi","2018-2019",16,2,1,50,1,50,22,14,11,10,1,7,17,41.2,10,14,4,10,15,37,43,3,24,45,34.8,"DF"
"Ryan Tunnicliffe","2018-2019",32,12,7,58.3,5,41.7,33,17,14,15,4,11,31,35.5,20,22,6,16,21,54,31,1,20,30,40,"MF"
"James McClean","2018-2019",260,90,52,57.8,38,42.2,59,36,26,19,14,27,54,50,27,33,2,31,21,80,56,0,76,109,41.1,"FW,MF"
"Bradley Dack","2018-2019",207,107,64,59.8,43,40.2,32,19,8,19,5,2,28,7.1,26,33,6,27,14,46,14,0,10,79,11.2,"MF"
"Trevoh Chalobah","2018-2019",36,68,48,70.6,20,29.4,57,36,23,31,3,23,51,45.1,28,54,19,35,55,112,90,0,112,117,48.9,"MF"
"Tom Trybull","2018-2019",8,13,11,84.6,2,15.4,72,42,37,32,3,28,62,45.2,34,54,10,44,68,140,60,0,82,76,51.9,"MF"
"Ahmed Hegazi","2018-2019",2,28,26,92.9,2,7.1,46,29,38,8,0,16,31,51.6,15,68,47,21,32,78,241,2,155,101,60.5,"DF"
"Jack Hobbs","2018-2019",3,2,1,50,1,50,34,18,27,7,0,14,29,48.3,15,21,14,7,54,88,138,1,123,45,73.2,"DF"
"Henrik Dalsgaard","2018-2019",261,33,18,54.5,15,45.5,90,58,65,20,5,47,76,61.8,29,26,11,15,61,151,124,0,138,128,51.9,"DF,MF"
"Ben Brereton","2018-2019",75,20,10,50,10,50,5,4,3,1,1,3,8,37.5,5,4,1,3,3,8,2,0,2,21,8.7,"FW"
"Andreas Weimann","2018-2019",237,59,31,52.5,28,47.5,25,18,5,9,11,6,16,37.5,10,39,2,37,19,44,24,0,34,75,31.2,"FW,MF"
"Saïd Benrahma","2018-2019",295,176,91,51.7,84,47.7,34,19,17,9,8,10,34,29.4,24,15,0,15,13,47,13,0,5,25,16.7,"FW"
"Tom Carroll","2018-2019",22,4,1,25,3,75,7,4,2,5,0,1,7,14.3,6,12,1,11,9,16,11,0,3,8,27.3,"MF"
"Ash Baker","2018-2019",33,8,1,12.5,7,87.5,31,24,17,14,0,10,18,55.6,8,18,6,12,15,46,46,0,9,21,30,"DF,MF"
"Sone Aluko","2018-2019",44,31,25,80.6,6,19.4,19,14,3,12,4,4,19,21.1,15,10,0,10,6,25,9,0,3,10,23.1,"MF,FW"
"Marcus Tavernier","2018-2019",50,22,13,59.1,9,40.9,9,7,5,2,2,5,10,50,5,6,1,5,4,13,11,0,8,11,42.1,"FW,MF"
"Julian Jeanvier","2018-2019",0,7,6,85.7,1,14.3,44,24,29,14,1,19,29,65.5,10,23,13,10,32,76,107,1,59,61,49.2,"DF"
"Timm Klose","2018-2019",7,4,3,75,1,25,38,25,28,6,4,18,28,64.3,10,30,18,12,26,64,122,0,92,38,70.8,"DF"
"Kemar Roofe","2018-2019",187,40,18,45,22,55,22,11,4,11,7,6,30,20,24,27,5,22,3,25,25,0,29,83,25.9,"FW,MF"
"Josh Dasilva","2018-2019",16,16,11,68.8,5,31.3,9,5,6,2,1,4,12,33.3,8,6,1,5,6,15,12,0,0,5,0,"MF"
"Jack Hunt","2018-2019",96,43,21,48.8,22,51.2,42,23,21,20,1,24,39,61.5,15,26,8,18,40,82,71,2,50,58,46.3,"DF"
"Josh Scowen","2018-2019",25,16,12,75,4,25,62,35,33,24,5,19,50,38,31,29,8,21,29,91,57,1,40,36,52.6,"MF"
"Ahmed Elmohamady","2018-2019",128,25,11,44,14,56,36,22,15,18,3,17,28,60.7,11,27,6,21,26,62,87,1,73,71,50.7,"DF,MF"
"Jack Lankester","2018-2019",31,25,15,60,10,40,10,6,3,4,3,3,9,33.3,6,4,0,4,3,13,2,0,2,8,20,"FW,MF"
"John Swift","2018-2019",93,70,48,68.6,22,31.4,46,27,23,21,2,19,48,39.6,29,24,4,20,27,73,31,0,19,40,32.2,"MF"
"Dominic Iorfa","2018-2019",23,12,8,66.7,4,33.3,26,17,17,9,0,11,16,68.8,5,11,3,8,16,42,41,1,41,12,77.4,"DF"
"Josh Onomah","2018-2019",34,20,10,50,10,50,30,21,15,11,4,12,24,50,12,24,2,22,11,41,9,1,8,14,36.4,"MF"
"Emi Buendía","2018-2019",157,92,55,59.8,37,40.2,101,64,43,42,16,42,119,35.3,77,57,3,54,32,133,18,1,21,42,33.3,"FW"
"Alex Pearce","2018-2019",1,2,1,50,1,50,8,4,8,0,0,7,9,77.8,2,11,11,0,18,26,66,0,48,26,64.9,"FW"
"Jake Bidwell","2018-2019",109,20,11,55,9,45,39,26,21,14,4,18,31,58.1,13,34,9,25,34,73,132,0,86,75,53.4,"DF"
"Stuart Dallas","2018-2019",83,20,8,40,12,60,43,26,23,16,4,19,31,61.3,12,11,0,11,16,59,24,1,28,29,49.1,"DF,MF"
"Tom Ince","2018-2019",249,77,37,48.1,40,51.9,41,27,18,19,4,13,35,37.1,22,27,3,24,18,59,19,1,9,50,15.3,"FW,MF"
"Evandro Goebel","2018-2019",50,21,15,71.4,6,28.6,24,13,9,10,5,5,26,19.2,21,11,0,11,18,42,4,0,10,28,26.3,"FW,MF"
"Teddy Bishop","2018-2019",34,41,24,58.5,17,41.5,28,16,10,12,6,13,18,72.2,5,12,2,10,17,45,9,0,10,23,30.3,"MF"
"Alan Hutton","2018-2019",84,36,27,75,9,25,35,18,26,7,2,19,35,54.3,16,30,15,15,18,53,142,3,59,53,52.7,"DF"
"Saidy Janko","2018-2019",58,29,16,55.2,13,44.8,37,28,23,9,5,19,24,79.2,5,11,2,9,8,45,34,0,15,35,30,"DF"
"Adam Armstrong","2018-2019",266,85,38,44.7,47,55.3,23,12,11,5,7,3,22,13.6,19,19,1,18,12,35,23,0,17,21,44.7,"FW,MF"
"Barrie McKay","2018-2019",101,37,19,51.4,18,48.6,19,11,5,10,4,5,11,45.5,6,9,0,9,6,25,8,0,8,18,30.8,"FW,MF"
"Flynn Downes","2018-2019",34,28,19,67.9,9,32.1,62,36,28,29,5,18,51,35.3,33,25,3,22,24,86,20,1,19,34,35.8,"MF"
"Joe Mattock","2018-2019",77,29,16,55.2,13,44.8,79,43,43,23,13,41,72,56.9,31,49,13,36,85,164,164,1,136,86,61.3,"DF"
"James Meredith","2018-2019",48,10,4,40,6,60,47,24,33,10,4,11,35,31.4,24,23,5,18,33,80,99,0,44,37,54.3,"DF"
"Ben Wiles","2018-2019",20,18,12,66.7,6,33.3,23,8,11,9,3,10,26,38.5,16,9,1,8,12,35,25,0,13,21,38.2,"MF"
"Tyler Roberts","2018-2019",178,40,23,57.5,17,42.5,16,8,3,8,5,2,14,14.3,12,10,0,10,6,22,9,0,26,51,33.8,"MF,FW"
"Daniel Johnson","2018-2019",58,17,10,58.8,7,41.2,37,24,11,25,1,14,34,41.2,20,31,3,28,26,63,40,1,17,39,30.4,"MF"
"Josh Sims","2018-2019",61,13,6,46.2,7,53.8,13,9,5,6,2,3,10,30,7,12,0,12,5,18,6,0,11,24,31.4,"FW,MF"
"Nathan Dyer","2018-2019",147,36,20,55.6,16,44.4,14,6,5,6,3,4,25,16,21,21,0,21,8,22,3,0,2,10,16.7,"FW"
"André Green","2018-2019",78,38,20,52.6,18,47.4,11,5,7,2,2,7,13,53.8,6,9,1,8,6,17,4,1,14,20,41.2,"MF,FW"
"Craig Forsyth","2018-2019",44,9,7,77.8,2,22.2,17,9,7,5,5,7,11,63.6,4,18,5,13,14,31,43,2,34,36,48.6,"DF"
"Yannick Bolasie","2018-2019",119,54,22,40.7,32,59.3,14,9,4,7,3,2,11,18.2,9,5,0,5,7,21,6,0,24,21,53.3,"MF,FW"
"Peter Crouch","2018-2019",34,5,1,20,4,80,2,1,1,1,0,1,1,100,0,2,0,2,0,2,8,0,79,50,61.2,"FW"
"Tom Clarke","2018-2019",32,6,4,66.7,2,33.3,29,20,17,12,0,9,22,40.9,13,12,7,5,21,50,81,0,107,76,58.5,"DF"
"Pelé","2018-2019",9,12,8,66.7,4,33.3,9,8,2,5,2,3,7,42.9,4,8,1,7,3,12,6,0,10,11,47.6,"MF"
"Gary O'Neil","2018-2019",65,29,14,48.3,15,51.7,61,40,23,25,13,24,56,42.9,32,19,2,17,9,70,31,5,26,51,33.8,"MF,FW"
"Alexander Tettey","2018-2019",15,18,10,55.6,8,44.4,28,17,18,8,2,17,32,53.1,15,19,7,12,46,74,61,0,61,47,56.5,"MF"
"Modou Barrow","2018-2019",190,67,34,50.7,33,49.3,35,18,11,15,9,9,24,37.5,15,45,0,45,6,41,17,0,10,49,16.9,"FW,MF"
"Moses Odubajo","2018-2019",151,54,24,44.4,30,55.6,44,20,32,10,2,22,42,52.4,20,29,2,27,18,62,56,1,25,61,29.1,"MF,DF"
"Eric Lichaj","2018-2019",73,28,17,60.7,11,39.3,83,53,65,14,4,38,60,63.3,22,38,12,26,25,108,143,0,78,59,56.9,"DF"
"Max Aarons","2018-2019",226,92,56,60.9,36,39.1,64,42,38,21,5,37,54,68.5,17,34,13,21,46,110,85,2,24,41,36.9,"DF"
"Will Vaulks","2018-2019",50,21,15,71.4,6,28.6,90,51,35,42,13,29,91,31.9,62,48,15,33,68,158,102,0,159,80,66.5,"MF"
"Romaine Sawyers","2018-2019",138,56,34,60.7,21,37.5,54,38,24,22,8,22,52,42.3,30,53,7,46,28,82,32,0,19,28,40.4,"MF"
"Kamohelo Mokotjo","2018-2019",38,27,19,70.4,8,29.6,42,26,18,18,6,15,34,44.1,19,24,1,23,50,92,26,0,7,19,26.9,"MF"
"Richie Towell","2018-2019",64,20,11,55,9,45,61,37,25,26,10,17,51,33.3,34,28,9,19,27,88,37,0,18,43,29.5,"MF"
"Matt Phillips","2018-2019",125,80,47,58.8,33,41.3,24,12,13,8,3,9,27,33.3,18,29,4,25,11,35,42,0,28,43,39.4,"MF,DF"
"Bruno Martins Indi","2018-2019",44,8,6,75,2,25,44,28,25,17,2,25,29,86.2,4,35,20,15,37,81,127,0,79,82,49.1,"DF"
"John O'Shea","2018-2019",0,1,1,100,0,0,9,6,6,3,0,5,6,83.3,1,4,2,2,14,23,38,0,31,8,79.5,"DF"
"Liam Ridgewell","2018-2019",0,1,1,100,0,0,6,4,4,2,0,4,8,50,4,8,4,4,8,14,29,0,17,5,77.3,"DF"
"Muhamed Bešić","2018-2019",65,85,53,62.4,32,37.6,51,29,26,20,5,14,47,29.8,33,25,2,23,22,73,17,0,6,14,30,"MF"
"Danny Graham","2018-2019",175,12,8,66.7,4,33.3,9,4,1,3,5,1,10,10,9,10,1,9,4,13,37,0,182,201,47.5,"FW"
"Jayden Stockley","2018-2019",46,7,5,71.4,2,28.6,2,2,1,1,0,2,3,66.7,1,1,1,0,1,3,15,1,77,74,51,"FW"
"Gareth Barry","2018-2019",16,10,6,60,4,40,37,22,22,15,0,14,31,45.2,17,17,5,12,24,61,23,1,32,15,68.1,"MF"
"Tom Lawrence","2018-2019",196,77,36,46.8,41,53.2,36,16,21,11,4,12,28,42.9,16,36,1,35,15,51,29,0,16,43,27.1,"FW"
"Fikayo Tomori","2018-2019",8,21,17,81,4,19,96,56,63,31,2,34,54,63,20,55,37,18,68,164,184,4,123,96,56.2,"DF"
"Seán Maguire","2018-2019",166,35,19,54.3,16,45.7,22,16,6,12,4,4,19,21.1,15,24,1,23,6,28,6,0,40,129,23.7,"FW,MF"
"Mame Biram Diouf","2018-2019",57,6,2,33.3,4,66.7,9,5,3,5,1,1,5,20,4,2,0,2,5,14,14,0,24,48,33.3,"FW,MF"
"Sam Hutchinson","2018-2019",12,8,5,62.5,3,37.5,60,33,25,33,2,23,43,53.5,20,35,12,23,52,112,46,0,38,16,70.4,"MF"
"Harrison Reed","2018-2019",100,31,19,61.3,12,38.7,66,44,28,31,7,28,68,41.2,40,43,8,35,40,106,34,0,26,56,31.7,"FW,MF"
"Eros Pisano","2018-2019",42,8,4,50,4,50,19,14,12,7,0,11,14,78.6,3,14,5,9,12,31,46,1,48,30,61.5,"DF"
"Matt Grimes","2018-2019",45,41,35,85.4,6,14.6,114,68,49,55,10,47,87,54,40,52,16,36,41,155,75,3,57,58,49.6,"MF,DF"
"Fraizer Campbell","2018-2019",141,39,18,46.2,21,53.8,29,20,8,13,8,4,28,14.3,24,13,3,10,8,37,25,0,52,82,38.8,"FW"
"Kamil Grosicki","2018-2019",314,97,36,37.1,61,62.9,19,13,6,10,3,13,32,40.6,19,14,2,12,16,35,9,0,6,17,26.1,"MF,FW"
"Yohan Benalouane","2018-2019",3,2,2,100,0,0,13,10,11,2,0,7,13,53.8,6,13,9,4,33,46,82,1,62,35,63.9,"DF"
"Tyrone Mings","2018-2019",3,11,9,81.8,2,18.2,15,9,10,5,0,5,10,50,5,21,14,7,18,33,69,2,41,18,69.5,"DF"
"Ryan Manning","2018-2019",29,26,17,65.4,9,34.6,47,28,25,15,7,14,33,42.4,19,22,5,17,35,82,44,0,26,33,44.1,"MF"
"Danny Fox","2018-2019",0,1,1,100,0,0,23,17,13,7,3,10,14,71.4,4,30,23,7,24,47,155,1,104,73,58.8,"DF"
"Marlon Pack","2018-2019",50,27,23,85.2,4,14.8,76,44,27,44,5,20,51,39.2,31,32,9,23,53,129,91,0,162,105,60.7,"MF"
"Luca Connell","2018-2019",7,19,12,63.2,7,36.8,19,10,11,7,1,4,17,23.5,13,6,2,4,10,29,14,1,4,9,30.8,"MF"
"Paweł Olkowski","2018-2019",85,69,38,55.1,31,44.9,90,63,57,28,5,38,75,50.7,37,37,17,20,37,127,114,1,67,52,56.3,"DF"
"Rico Henry","2018-2019",75,21,11,52.4,10,47.6,23,15,12,8,3,14,26,53.8,12,12,3,9,21,44,33,1,24,15,61.5,"MF,DF"
"Paddy McNair","2018-2019",31,14,5,35.7,9,64.3,19,10,11,6,2,9,16,56.3,7,4,1,3,7,26,29,0,20,30,40,"DF"
"Jamie Paterson","2018-2019",173,91,42,46.2,49,53.8,41,24,17,21,3,13,48,27.1,35,39,0,39,35,76,29,0,12,38,24,"MF,FW"
"Lee Evans","2018-2019",62,24,13,54.2,11,45.8,42,25,15,21,6,20,47,42.6,27,41,13,28,23,65,29,1,46,53,46.5,"MF"
"Tom Lees","2018-2019",6,6,5,83.3,1,16.7,47,29,37,10,0,12,18,66.7,6,65,46,19,63,110,240,3,231,106,68.5,"DF"
"Nico Yennaris","2018-2019",28,12,5,41.7,7,58.3,21,11,9,9,3,10,17,58.8,7,19,2,17,8,29,12,1,5,20,20,"MF"
"Jamie Shackleton","2018-2019",20,5,1,20,4,80,11,7,6,4,1,3,9,33.3,6,4,0,4,3,14,7,0,4,17,19,"DF,MF"
"Joe Rodon","2018-2019",5,11,10,90.9,1,9.1,21,11,15,6,0,9,13,69.2,4,30,23,7,33,54,146,2,99,49,66.9,"DF"
"Declan John","2018-2019",44,20,8,40,12,60,13,6,11,1,1,4,8,50,4,6,1,5,4,17,20,1,0,8,0,"DF,MF"
"Martyn Waghorn","2018-2019",142,30,7,23.3,23,76.7,31,23,12,11,8,5,31,16.1,26,23,2,21,7,38,30,0,58,110,34.5,"FW"
"Andre Dozzell","2018-2019",29,9,4,44.4,5,55.6,8,5,1,5,2,4,14,28.6,10,6,0,6,6,14,8,0,5,25,16.7,"MF,FW"
"John McGinn","2018-2019",145,86,70,81.4,16,18.6,83,53,21,52,10,26,76,34.2,50,49,8,41,39,122,24,2,38,58,39.6,"MF"
"Michael Hefele","2018-2019",1,3,2,66.7,1,33.3,11,7,11,0,0,5,7,71.4,2,17,10,7,15,26,55,0,29,22,56.9,"DF"
"Leon Clarke","2018-2019",110,6,4,66.7,2,33.3,11,6,4,2,5,0,6,0,6,11,5,6,3,14,26,0,106,117,47.5,"FW"
"Liam Palmer","2018-2019",86,27,13,48.1,14,51.9,71,48,43,22,6,30,44,68.2,14,32,9,23,38,109,95,0,32,27,54.2,"DF"
"Àngel Rangel","2018-2019",24,9,6,66.7,3,33.3,44,25,25,14,5,19,28,67.9,9,23,10,13,35,79,73,2,29,32,47.5,"DF"
"Patrick Bamford","2018-2019",135,21,9,42.9,12,57.1,12,9,1,6,5,3,16,18.8,13,6,0,6,3,15,18,0,24,46,34.3,"FW"
"Moritz Leitner","2018-2019",69,20,10,50,10,50,42,30,23,11,8,13,30,43.3,17,24,4,20,15,57,21,0,7,24,22.6,"MF,FW"
"Barry Bannan","2018-2019",51,47,37,78.7,10,21.3,60,36,29,29,2,22,64,34.4,42,52,12,40,38,98,50,1,18,35,34,"MF"
"Aden Flint","2018-2019",25,6,2,33.3,4,66.7,36,24,23,13,0,18,33,54.5,15,43,36,7,26,62,230,1,186,76,71,"DF"
"Jack Colback","2018-2019",39,12,8,66.7,4,33.3,120,74,60,50,10,42,71,59.2,29,53,16,37,55,175,50,0,37,38,49.3,"MF"
"Mason Mount","2018-2019",185,41,21,51.2,20,48.8,48,26,17,23,8,17,56,30.4,39,30,2,28,18,66,28,1,17,42,28.8,"MF"
"Massimo Luongo","2018-2019",58,47,35,74.5,12,25.5,126,69,38,74,14,36,86,41.9,50,70,14,56,58,184,81,0,102,67,60.4,"MF"
"Daniel Batty","2018-2019",16,16,12,75,4,25,54,28,36,18,0,18,55,32.7,37,17,7,10,30,84,42,1,14,28,33.3,"MF"
"Sam Clucas","2018-2019",94,13,5,38.5,8,61.5,50,24,27,18,5,19,35,54.3,16,15,3,12,20,70,42,0,48,50,49,"MF,DF"
"Yanic Wildschut","2018-2019",42,39,13,33.3,26,66.7,8,4,5,3,0,1,6,16.7,5,5,0,5,6,14,8,1,12,10,54.5,"FW,MF"
"Richard Stearman","2018-2019",1,1,1,100,0,0,0,0,0,0,0,0,0,NA,0,3,3,0,6,6,33,0,20,12,62.5,"DF"
"Gwion Edwards","2018-2019",143,88,44,50,44,50,83,57,39,35,9,27,70,38.6,43,62,6,56,30,113,24,0,36,101,26.3,"FW,MF"
"Marc Pugh","2018-2019",68,25,18,72,7,28,9,7,1,7,1,3,10,30,7,11,2,9,6,15,5,0,10,25,28.6,"FW,MF"
"Christian Doidge","2018-2019",40,6,3,50,3,50,3,2,0,2,1,0,2,0,2,5,1,4,1,4,9,0,78,97,44.6,"FW"
"Tom Barkhuizen","2018-2019",171,71,27,38,45,63.4,32,15,13,12,7,12,26,46.2,14,34,3,31,16,48,49,0,46,89,34.1,"FW,MF"
"Sam Baldock","2018-2019",104,17,9,52.9,8,47.1,18,9,5,11,2,4,11,36.4,7,3,1,2,3,21,15,0,12,63,16,"FW"
"Leandro Bacuna","2018-2019",41,34,20,58.8,14,41.2,32,23,17,13,2,14,31,45.2,17,14,2,12,20,52,35,1,27,33,45,"MF"
"Lucas João","2018-2019",109,42,26,61.9,16,38.1,18,13,8,6,4,3,18,16.7,15,28,7,21,6,24,33,1,45,82,35.4,"FW,MF"
"Martin Cranie","2018-2019",13,3,3,100,0,0,16,9,8,7,1,7,12,58.3,5,17,7,10,12,28,45,0,31,14,68.9,"DF"
"Paul Gallagher","2018-2019",62,14,8,57.1,6,42.9,61,38,25,27,9,29,64,45.3,35,38,8,30,34,95,35,0,23,49,31.9,"MF,FW"
"Adam Forshaw","2018-2019",44,27,19,70.4,8,29.6,66,39,24,41,1,29,56,51.8,27,19,2,17,20,86,18,4,35,29,54.7,"MF"
"Cédric Kipré","2018-2019",13,15,10,66.7,5,33.3,47,34,40,6,1,15,29,51.7,14,57,34,23,34,81,195,3,114,69,62.3,"DF"
"Jota","2018-2019",124,92,42,45.7,50,54.3,37,21,17,12,8,10,39,25.6,29,20,3,17,17,54,28,0,18,37,32.7,"MF"
"Ben Godfrey","2018-2019",15,11,7,63.6,4,36.4,33,28,25,6,2,10,20,50,10,34,15,19,22,55,117,1,63,53,54.3,"DF"
"Bojan Krkić","2018-2019",53,30,15,50,15,50,9,6,4,5,0,3,17,17.6,14,8,0,8,6,15,2,0,3,8,27.3,"MF,FW"
"Matt Miazga","2018-2019",0,5,3,60,2,40,22,18,19,3,0,14,16,87.5,2,14,9,5,13,35,131,0,75,19,79.8,"DF"
"Joe Allen","2018-2019",162,58,25,43.1,33,56.9,125,79,56,61,8,38,82,46.3,44,53,7,46,65,190,64,0,59,80,42.4,"MF"
"Jordan Roberts","2018-2019",59,4,1,25,2,50,6,4,0,5,1,1,11,9.1,10,4,0,4,1,7,6,0,26,37,41.3,"FW"
"Jack Rodwell","2018-2019",1,1,1,100,0,0,24,15,13,11,0,6,15,40,9,18,11,7,15,39,49,0,39,30,56.5,"DF,MF"
"Shane Ferguson","2018-2019",93,20,13,65,7,35,28,20,18,9,1,11,22,50,11,32,5,27,16,44,30,0,6,11,35.3,"MF,DF"
"Conor Washington","2018-2019",38,10,4,40,6,60,2,1,1,1,0,1,5,20,4,2,0,2,3,5,0,0,6,24,20,"FW"
"Sam Morsy","2018-2019",30,37,31,83.8,6,16.2,112,67,41,62,9,39,94,41.5,55,62,22,40,38,150,33,1,42,50,45.7,"MF"
"Jordan Hugill","2018-2019",124,18,5,27.8,13,72.2,9,7,3,5,1,1,9,11.1,8,10,1,9,2,11,29,0,124,195,38.9,"FW"
"Josh Earl","2018-2019",32,9,4,44.4,5,55.6,19,12,14,4,1,11,19,57.9,8,12,4,8,16,35,44,1,44,21,67.7,"DF"
"Joel Lynch","2018-2019",3,9,9,100,0,0,38,26,26,12,0,9,24,37.5,15,29,20,9,37,75,238,3,167,74,69.3,"DF"
"Molla Wagué","2018-2019",2,4,3,75,1,25,13,7,12,1,0,4,5,80,1,8,5,3,11,24,45,0,47,46,50.5,"DF"
"Stefan Johansen","2018-2019",33,5,4,80,1,20,7,6,2,4,1,2,16,12.5,14,8,1,7,6,13,7,1,6,8,42.9,"MF"
"Ashley Williams","2018-2019",9,6,6,100,0,0,38,22,29,9,0,15,28,53.6,13,28,21,7,66,104,143,0,62,52,54.4,"DF"
"Tiago Ilori","2018-2019",2,9,9,100,0,0,21,13,17,4,0,8,11,72.7,3,18,13,5,31,52,105,4,48,31,60.8,"DF"
"Reece Burke","2018-2019",17,7,4,57.1,3,42.9,58,39,37,19,2,34,52,65.4,18,31,24,7,24,82,203,1,117,63,65,"DF"
"Tyler Blackett","2018-2019",58,22,16,72.7,6,27.3,49,32,35,14,0,18,25,72,7,25,11,14,31,80,118,3,47,56,45.6,"DF"
"Ben Pearson","2018-2019",38,22,17,77.3,5,22.7,82,48,36,40,6,38,78,48.7,40,33,6,27,52,134,54,1,33,21,61.1,"MF"
"Ovie Ejaria","2018-2019",31,52,36,69.2,16,30.8,29,18,11,17,1,8,29,27.6,21,13,2,11,17,46,18,2,15,30,33.3,"MF,FW"
"Brad Potts","2018-2019",50,5,4,80,1,20,10,7,4,4,2,5,10,50,5,15,4,11,5,15,10,0,17,15,53.1,"FW,MF"
"Zak Vyner","2018-2019",18,8,5,62.5,3,37.5,58,38,42,14,2,28,51,54.9,23,40,9,31,38,96,109,1,37,37,50,"DF"
"Billy Jones","2018-2019",23,8,6,75,2,25,32,13,19,9,4,13,18,72.2,5,30,11,19,21,53,46,0,41,36,53.2,"DF"
"Jake Cooper","2018-2019",23,7,6,85.7,1,14.3,32,18,22,9,1,15,26,57.7,11,48,38,10,41,73,277,0,283,126,69.2,"DF"
"Jack Harrison","2018-2019",285,74,30,40.5,44,59.5,36,22,12,18,6,13,41,31.7,28,25,1,24,14,50,20,0,22,63,25.9,"MF,FW"
"Andre Wisdom","2018-2019",11,1,1,100,0,0,23,12,15,8,0,6,15,40,9,10,3,7,16,39,25,0,16,15,51.6,"DF"
"Mason Bennett","2018-2019",102,29,11,37.9,18,62.1,24,17,6,13,5,3,21,14.3,18,19,4,15,16,40,10,0,64,72,47.1,"FW,MF"
"Daryl Murphy","2018-2019",72,7,4,57.1,3,42.9,6,3,0,3,3,1,4,25,3,8,3,5,3,9,30,0,117,113,50.9,"FW"
"Sammy Ameobi","2018-2019",142,114,63,55.3,51,44.7,45,29,21,13,11,16,39,41,23,30,1,29,19,64,30,0,57,66,46.3,"FW,MF"
"Joe Garner","2018-2019",82,11,2,18.2,9,81.8,13,6,3,6,4,0,3,0,3,10,2,8,2,15,21,0,132,177,42.7,"FW"
"Ryan Williams","2018-2019",149,59,27,45.8,32,54.2,53,34,25,19,9,17,47,36.2,30,30,5,25,31,84,31,1,39,66,37.1,"MF,FW"
"Eberechi Eze","2018-2019",173,114,66,57.9,48,42.1,30,20,10,13,7,7,25,28,18,33,3,30,21,51,17,1,22,88,20,"FW,MF"
"Jayden Bogle","2018-2019",192,96,52,54.2,44,45.8,100,58,51,39,10,43,77,55.8,34,38,14,24,33,133,78,3,36,45,44.4,"DF"
"Ollie Watkins","2018-2019",418,88,39,44.3,48,54.5,30,22,1,16,13,9,33,27.3,24,33,1,32,14,44,15,0,59,105,36,"FW,MF"
"Jack Grealish","2018-2019",156,86,53,61.6,33,38.4,36,23,13,18,5,7,16,43.8,9,20,4,16,17,53,20,0,20,26,43.5,"MF,FW"
"Stewart Downing","2018-2019",146,45,18,40,27,60,13,10,6,5,2,6,19,31.6,13,27,3,24,29,42,30,0,6,16,27.3,"FW,MF"
"Will Buckley","2018-2019",88,27,8,29.6,19,70.4,19,10,7,9,3,6,24,25,18,18,4,14,6,25,25,0,15,34,30.6,"FW,MF"
"Dan Burn","2018-2019",6,6,4,66.7,2,33.3,23,16,15,7,1,8,16,50,8,12,5,7,16,39,85,2,60,14,81.1,"DF"
"Anthony Pilkington","2018-2019",32,22,10,45.5,12,54.5,9,7,5,0,4,2,7,28.6,5,4,0,4,6,15,9,0,8,23,25.8,"MF,FW"
"Liam Kelly","2018-2019",42,15,8,53.3,7,46.7,31,20,18,12,1,7,26,26.9,19,17,3,14,24,55,17,0,6,17,26.1,"MF"
"Oghenekaro Etebo","2018-2019",77,54,40,74.1,14,25.9,58,41,24,29,5,24,64,37.5,40,44,7,37,37,95,26,2,21,33,38.9,"MF"
"Marco Stiepermann","2018-2019",299,126,54,42.9,72,57.1,60,34,17,31,12,20,48,41.7,28,56,5,51,11,71,39,0,76,110,40.9,"MF"
"Jón Daði Böðvarsson","2018-2019",62,9,3,33.3,6,66.7,10,6,0,8,2,1,2,50,1,8,1,7,3,13,8,0,58,84,40.8,"FW"
"John Fleck","2018-2019",116,88,59,67,29,33,58,26,22,27,9,28,67,41.8,39,50,19,31,54,112,57,0,36,48,42.9,"MF"
"Benik Afobe","2018-2019",199,34,15,44.1,19,55.9,27,17,7,14,6,7,22,31.8,15,17,1,16,9,36,31,0,88,162,35.2,"FW"
"Richard Wood","2018-2019",0,2,1,50,1,50,20,13,16,4,0,6,12,50,6,21,12,9,25,45,129,0,100,74,57.5,"DF"
"Matt Penney","2018-2019",44,30,15,50,15,50,27,17,14,10,3,8,21,38.1,13,10,2,8,8,35,37,1,10,19,34.5,"DF,MF"
"Michael Smith","2018-2019",296,38,27,71.1,11,28.9,29,15,5,14,10,3,22,13.6,19,51,8,43,7,36,75,0,359,335,51.7,"FW"
"Jake Livermore","2018-2019",39,18,15,83.3,3,16.7,70,42,25,40,5,22,37,59.5,15,57,16,41,42,112,46,1,18,18,50,"MF"
"Ryan Nyambe","2018-2019",78,60,31,51.7,29,48.3,45,35,25,15,5,18,24,75,6,42,16,26,24,69,69,0,40,52,43.5,"DF"
"Ben Marshall","2018-2019",49,15,7,46.7,8,53.3,34,27,20,9,5,17,42,40.5,25,21,3,18,8,42,23,0,23,29,44.2,"MF"
"Graham Burke","2018-2019",42,6,3,50,3,50,10,5,6,4,0,3,9,33.3,6,6,1,5,1,11,3,0,10,28,26.3,"FW,MF"
"Liam Moore","2018-2019",5,9,7,77.8,2,22.2,31,18,22,9,0,11,25,44,14,53,43,10,44,75,260,1,175,120,59.3,"DF"
"Sam Field","2018-2019",8,3,3,100,0,0,21,13,6,14,1,9,20,45,11,14,3,11,15,36,14,0,11,19,36.7,"MF"
"Claudio Yacob","2018-2019",5,4,3,75,1,25,29,16,13,12,4,18,25,72,7,14,6,8,8,37,27,0,29,22,56.9,"MF,DF"
"Ashley Cole","2018-2019",31,8,6,75,2,25,11,6,9,2,0,6,11,54.5,5,16,11,5,5,16,18,1,8,10,44.4,"DF"
"Andy Yiadom","2018-2019",188,127,64,50.4,63,49.6,103,46,63,31,9,50,73,68.5,23,60,26,34,56,159,192,2,121,96,55.8,"DF"
"Jiří Skalák","2018-2019",30,7,3,42.9,4,57.1,4,2,0,2,2,2,7,28.6,5,4,0,4,4,8,6,0,4,10,28.6,"MF"
"Tendayi Darikwa","2018-2019",89,32,18,56.3,14,43.8,49,33,34,12,3,18,42,42.9,24,28,12,16,53,102,91,2,31,38,44.9,"DF"
"Darnell Fisher","2018-2019",80,29,11,37.9,17,58.6,72,52,39,31,2,33,57,57.9,24,60,15,45,36,108,98,0,57,58,49.6,"DF"
"Kortney Hause","2018-2019",18,7,5,71.4,2,28.6,9,6,4,4,1,5,7,71.4,2,17,8,9,6,15,46,1,54,24,69.2,"DF"
"Pablo Hernández","2018-2019",309,88,41,46.6,47,53.4,64,43,30,29,5,27,79,34.2,52,46,1,45,21,85,23,2,6,36,14.3,"MF,FW"
"James Bree","2018-2019",46,7,5,71.4,2,28.6,31,22,19,10,2,15,26,57.7,11,22,8,14,33,64,55,2,46,32,59,"DF"
"Derrick Williams","2018-2019",32,10,8,80,2,20,31,17,23,8,0,18,29,62.1,11,30,17,13,46,77,98,0,104,70,59.8,"DF"
"Kieron Freeman","2018-2019",118,14,7,50,7,50,35,20,19,11,5,15,32,46.9,17,20,5,15,18,53,40,0,20,48,29.4,"DF"
"Ryan Yates","2018-2019",16,8,3,37.5,5,62.5,23,13,10,11,2,8,17,47.1,9,16,3,13,21,44,19,0,18,41,30.5,"MF"
"Chris Martin","2018-2019",76,5,2,40,3,60,10,7,3,7,0,2,11,18.2,9,5,0,5,2,12,20,0,78,142,35.5,"FW"
"Jon Nolan","2018-2019",80,27,14,51.9,13,48.1,34,20,11,18,5,10,33,30.3,23,20,8,12,17,51,23,1,28,38,42.4,"MF"
"Richard Smallwood","2018-2019",15,9,6,66.7,3,33.3,59,33,25,30,4,10,40,25,30,33,9,24,31,90,41,0,39,30,56.5,"MF"
"Lewis Wing","2018-2019",75,22,10,45.5,12,54.5,53,26,18,21,14,15,46,32.6,31,42,7,35,16,69,20,0,18,39,31.6,"MF"
"Neil Taylor","2018-2019",83,19,15,78.9,4,21.1,49,29,25,20,4,27,36,75,9,24,5,19,18,67,87,1,28,45,38.4,"DF"
"Marc Wilson","2018-2019",2,6,5,83.3,1,16.7,27,16,15,12,0,13,25,52,12,17,10,7,17,44,61,2,38,25,60.3,"DF,MF"
"Nathan Byrne","2018-2019",91,34,21,61.8,13,38.2,45,26,31,13,1,26,47,55.3,21,20,3,17,13,58,64,0,20,39,33.9,"DF,MF"
"George Saville","2018-2019",85,40,20,50,20,50,71,45,31,36,4,16,52,30.8,36,47,14,33,33,104,65,0,63,69,47.7,"MF,DF"
"Chey Dunkley","2018-2019",9,5,3,60,2,40,33,17,22,11,0,8,13,61.5,5,64,49,15,44,77,239,3,218,94,69.9,"DF"
"Yoann Barbet","2018-2019",45,28,18,64.3,10,35.7,44,31,22,11,11,19,38,50,19,36,10,26,42,86,97,1,69,65,51.5,"DF"
"Yakou Méïte","2018-2019",159,54,29,53.7,25,46.3,35,20,15,16,4,9,23,39.1,14,28,3,25,15,50,34,0,130,140,48.1,"FW,MF"
"Rolando Aarons","2018-2019",32,30,14,46.7,16,53.3,10,5,6,3,1,3,13,23.1,10,9,0,9,5,15,5,0,6,10,37.5,"MF,FW"
"Aiden O'Brien","2018-2019",87,36,18,50,18,50,26,14,12,10,4,12,22,54.5,10,21,2,19,10,36,12,0,20,51,28.2,"MF,FW"
"Joe Lolley","2018-2019",243,188,109,58,79,42,58,37,22,27,9,17,68,25,51,57,3,54,36,94,43,0,29,54,34.9,"FW,MF"
"James Collins","2018-2019",0,3,3,100,0,0,6,4,5,1,0,4,7,57.1,3,9,6,3,9,15,48,0,41,21,66.1,"DF"
"Nouha Dicko","2018-2019",29,11,6,54.5,5,45.5,4,3,0,2,2,0,2,0,2,7,0,7,2,6,0,0,9,30,23.1,"FW"
"Harry Wilson","2018-2019",198,49,18,36.7,31,63.3,50,27,17,25,8,15,60,25,45,21,2,19,23,73,25,0,6,58,9.4,"FW,MF"
"Albert Adomah","2018-2019",177,47,18,38.3,29,61.7,53,38,27,22,4,19,46,41.3,27,25,2,23,20,73,19,0,21,47,30.9,"MF,FW"
"Michael Morrison","2018-2019",14,2,1,50,1,50,55,37,36,18,1,19,36,52.8,17,52,27,25,52,107,244,1,174,145,54.5,"DF"
"Tosin Adarabioyo","2018-2019",27,27,18,66.7,9,33.3,48,34,36,8,4,25,37,67.6,12,28,15,13,36,84,102,3,88,37,70.4,"DF"
"Jacques Maghoma","2018-2019",124,91,33,36.3,58,63.7,59,37,20,30,9,21,42,50,21,52,1,51,25,84,24,0,12,30,28.6,"MF"
"Barry Douglas","2018-2019",109,10,6,60,4,40,53,31,33,15,5,25,44,56.8,19,22,3,19,18,71,58,2,50,58,46.3,"DF,MF"
"Callum O'Dowda","2018-2019",112,49,30,61.2,19,38.8,30,21,15,14,1,7,32,21.9,25,24,1,23,21,51,30,0,46,67,40.7,"MF"
"Ben Davies","2018-2019",1,1,1,100,0,0,60,43,43,17,0,20,28,71.4,8,59,47,12,54,114,244,2,170,101,62.7,"DF"
"Ellis Harrison","2018-2019",47,8,4,50,3,37.5,10,8,1,6,3,3,7,42.9,4,8,2,6,5,15,9,0,55,93,37.2,"FW,MF"
"Moritz Bauer","2018-2019",21,9,3,33.3,6,66.7,8,6,6,2,0,1,7,14.3,6,5,1,4,4,12,12,1,10,6,62.5,"DF"
"Mason Holgate","2018-2019",108,50,24,48,26,52,50,33,27,16,7,23,35,65.7,12,18,4,14,30,80,50,0,39,24,61.9,"DF"
"Richard Keogh","2018-2019",9,9,7,77.8,2,22.2,36,24,27,8,1,13,23,56.5,10,51,39,12,42,78,218,4,178,120,59.7,"DF"
"Clayton Donaldson","2018-2019",136,19,12,63.2,7,36.8,26,15,9,12,5,5,19,26.3,14,22,2,20,6,32,22,1,79,112,41.4,"FW"
"Kal Naismith","2018-2019",76,56,37,66.1,19,33.9,27,16,22,4,1,20,45,44.4,25,43,23,20,14,41,82,2,42,34,55.3,"DF,MF"
"Michael Jacobs","2018-2019",80,44,19,43.2,25,56.8,31,12,14,11,6,10,34,29.4,24,34,5,29,11,42,24,0,32,46,41,"FW,MF"
"Jordan Cousins","2018-2019",54,11,8,72.7,3,27.3,38,21,13,18,7,20,42,47.6,22,30,8,22,20,58,40,1,35,35,50,"MF,DF"
"Glenn Whelan","2018-2019",17,7,5,71.4,2,28.6,46,26,15,26,5,16,35,45.7,19,28,7,21,27,73,41,2,37,36,50.7,"MF"
"Fernando Forestieri","2018-2019",92,52,40,76.9,12,23.1,39,23,15,19,5,10,27,37,17,13,1,12,6,45,3,0,12,24,33.3,"FW,MF"
"Semi Ajayi","2018-2019",22,29,18,62.1,11,37.9,93,62,60,28,5,27,55,49.1,28,61,25,36,52,145,164,5,196,117,62.6,"DF,MF"
"Tom Elliott","2018-2019",86,8,4,50,4,50,9,7,1,5,3,0,5,0,5,7,0,7,1,10,23,0,191,148,56.3,"FW"
"Michael Ihiekwe","2018-2019",6,5,4,80,1,20,22,14,14,7,1,9,13,69.2,4,8,4,4,21,43,96,1,70,42,62.5,"DF"
"David Davis","2018-2019",1,10,9,90,1,10,12,7,3,8,1,5,12,41.7,7,13,4,9,9,21,16,0,8,8,50,"MF"
"Birkir Bjarnason","2018-2019",23,4,0,0,4,100,14,11,7,5,2,6,19,31.6,13,8,0,8,5,19,18,0,35,31,53,"MF"
"David McGoldrick","2018-2019",265,90,49,54.4,41,45.6,50,32,23,19,8,8,40,20,32,29,3,26,12,62,42,1,130,194,40.1,"FW"
"Josh Windass","2018-2019",178,40,17,42.5,23,57.5,21,12,5,10,6,10,30,33.3,20,17,2,15,6,27,10,1,14,49,22.2,"FW,MF"
"Liam Cooper","2018-2019",7,16,14,87.5,2,12.5,65,41,34,27,4,19,38,50,19,44,30,14,84,149,144,3,183,108,62.9,"DF"
"Todd Kane","2018-2019",105,27,14,51.9,13,48.1,52,30,31,21,0,35,58,60.3,23,42,14,28,24,76,112,2,27,83,24.5,"DF,MF"
"Matt Palmer","2018-2019",5,1,0,0,1,100,9,6,2,5,2,3,6,50,3,8,2,6,8,17,5,0,5,14,26.3,"MF"
"Jacob Murphy","2018-2019",70,26,15,57.7,11,42.3,8,1,5,2,1,2,12,16.7,10,9,0,9,1,9,3,0,3,19,13.6,"FW,MF"
"John Egan","2018-2019",7,5,5,100,0,0,54,32,39,14,1,29,42,69,13,48,29,19,58,112,263,0,192,110,63.6,"DF"
"Josh Vela","2018-2019",25,8,2,25,6,75,29,19,10,15,4,4,15,26.7,11,14,0,14,11,40,20,1,18,40,31,"MF"
"Ben Watson","2018-2019",4,6,4,66.7,2,33.3,26,18,14,10,2,7,27,25.9,20,25,10,15,23,49,33,0,10,18,35.7,"MF"
"Tomáš Kalas","2018-2019",12,12,6,50,5,41.7,33,17,21,10,2,9,20,45,11,58,41,17,81,114,208,2,163,79,67.4,"DF"
"Jason Lowe","2018-2019",23,8,5,62.5,3,37.5,51,36,25,25,1,17,29,58.6,12,35,17,18,71,122,90,1,43,64,40.2,"MF,DF"
"Bradley Johnson","2018-2019",22,12,7,58.3,5,41.7,43,30,18,24,1,20,42,47.6,22,25,12,13,48,91,43,1,93,60,60.8,"MF"
"Florian Jozefzoon","2018-2019",102,34,16,47.1,18,52.9,12,7,6,6,0,2,8,25,6,10,0,10,7,19,17,0,6,28,17.6,"FW,MF"
"Kerim Mrabti","2018-2019",45,6,3,50,3,50,18,6,9,6,3,4,12,33.3,8,7,1,6,5,23,9,0,9,13,40.9,"MF"
"Myles Kenlock","2018-2019",27,44,26,59.1,18,40.9,36,22,24,12,0,19,42,45.2,23,16,4,12,22,58,52,2,35,44,44.3,"DF"
"Lewis Macleod","2018-2019",69,13,10,76.9,3,23.1,31,16,13,12,6,6,20,30,14,15,0,15,6,37,11,0,6,28,17.6,"MF"
"Gary Madine","2018-2019",63,8,2,25,6,75,5,2,1,3,1,2,5,40,3,5,0,5,3,8,8,0,74,57,56.5,"FW"
"Famara Diedhiou","2018-2019",233,62,29,46.8,33,53.2,28,15,6,13,9,6,26,23.1,20,17,2,15,2,30,65,0,224,257,46.6,"FW"
"Jack Marriott","2018-2019",126,12,3,25,9,75,13,7,2,7,4,3,14,21.4,11,18,3,15,5,18,6,0,19,94,16.8,"FW"
"Dwight Gayle","2018-2019",188,29,15,51.7,14,48.3,23,17,7,11,5,9,27,33.3,18,14,0,14,14,37,4,0,34,81,29.6,"FW"
"Gil Bastião Dias","2018-2019",57,32,20,62.5,12,37.5,41,25,19,19,3,11,34,32.4,23,19,1,18,13,54,9,0,8,24,25,"FW"
"Liam Walsh","2018-2019",7,10,7,70,3,30,10,4,2,8,0,6,9,66.7,3,2,0,2,5,15,3,0,2,8,20,"MF"
"Kyle Naughton","2018-2019",67,37,20,54.1,17,45.9,57,28,31,24,2,23,48,47.9,25,29,10,19,38,95,83,1,49,51,49,"DF,MF"
"Billy Sharp","2018-2019",298,18,5,27.8,13,72.2,17,10,4,10,3,5,23,21.7,18,8,0,8,5,22,5,0,40,122,24.7,"FW"
"Jon Taylor","2018-2019",143,54,23,42.6,31,57.4,39,27,17,11,11,15,52,28.8,37,20,0,20,19,58,34,0,26,58,31,"MF,FW"
"Grant Hanley","2018-2019",0,1,1,100,0,0,12,6,6,5,1,2,2,100,0,10,9,1,8,20,44,0,27,17,61.4,"DF"
"Andy Rinomhota","2018-2019",53,45,33,73.3,12,26.7,61,41,30,27,4,22,35,62.9,13,23,11,12,26,87,46,0,24,34,41.4,"MF,DF"
"Aristote Nsiala","2018-2019",7,7,4,57.1,3,42.9,32,22,22,10,0,13,20,65,7,33,21,12,48,80,127,1,110,52,67.9,"DF"
"Danny Loader","2018-2019",53,27,18,66.7,9,33.3,4,2,3,0,1,1,8,12.5,7,5,1,4,2,6,7,0,9,29,23.7,"MF,FW"
"Ryan Woods","2018-2019",24,25,20,80,5,20,32,23,10,21,1,10,28,35.7,18,22,10,12,16,48,28,0,28,35,44.4,"MF"
"Jonas Knudsen","2018-2019",70,10,4,40,6,60,42,28,17,21,4,15,23,65.2,8,31,11,20,30,72,113,1,102,72,58.6,"DF"
"Chris Brunt","2018-2019",40,12,7,58.3,5,41.7,49,23,23,22,4,13,40,32.5,27,34,8,26,15,64,32,1,33,22,60,"MF"
"Jonathan Kodjia","2018-2019",218,70,44,62.9,26,37.1,15,9,5,6,4,5,18,27.8,13,10,1,9,5,20,17,0,44,70,38.6,"FW,MF"
"Marc McNulty","2018-2019",36,5,2,40,3,60,1,0,1,0,0,0,2,0,2,1,0,1,2,3,0,0,12,14,46.2,"FW"
"Ben Thompson","2018-2019",36,16,12,75,4,25,24,13,9,12,3,7,17,41.2,10,6,2,4,12,36,19,1,45,51,46.9,"FW,MF"
"Ashley Fletcher","2018-2019",102,20,10,50,10,50,14,10,5,5,4,2,10,20,8,15,1,14,3,17,17,0,41,75,35.3,"FW,MF"
"Jamal Lewis","2018-2019",190,81,46,56.8,35,43.2,71,42,45,20,6,39,56,69.6,17,40,7,33,39,110,83,0,27,48,36,"DF"
"Darron Gibson","2018-2019",3,3,1,33.3,2,66.7,22,11,9,10,3,7,14,50,7,14,6,8,19,41,22,0,6,5,54.5,"MF"
"Marco Matias","2018-2019",112,34,11,32.4,23,67.6,48,31,26,16,6,14,36,38.9,22,40,4,36,15,63,19,1,20,46,30.3,"MF,FW"
"Scott Malone","2018-2019",98,29,21,72.4,8,27.6,49,29,29,19,1,18,40,45,22,27,9,18,41,90,54,1,31,30,50.8,"DF"
"Danny Batth","2018-2019",3,4,3,75,1,25,35,16,29,6,0,14,27,51.9,13,27,19,8,44,79,158,1,120,41,74.5,"DF"
"Che Adams","2018-2019",332,78,39,50,39,50,26,20,4,16,6,2,9,22.2,7,28,3,25,8,34,26,0,38,133,22.2,"FW"
"George Byers","2018-2019",42,11,7,63.6,4,36.4,31,15,8,17,6,8,32,25,24,28,6,22,14,45,27,1,18,18,50,"MF"
"Tammy Abraham","2018-2019",190,51,30,58.8,21,41.2,17,6,2,13,2,3,11,27.3,8,27,7,20,8,25,39,0,105,158,39.9,"FW"
"Todd Cantwell","2018-2019",114,51,26,51,25,49,24,18,11,10,3,13,35,37.1,22,18,1,17,16,40,23,0,9,22,29,"FW"
"Nélson Oliveira","2018-2019",52,31,16,51.6,15,48.4,6,2,0,5,1,0,1,0,1,3,0,3,0,6,9,1,11,22,33.3,"FW"
"Adlène Guedioura","2018-2019",41,51,35,68.6,16,31.4,50,30,19,27,4,15,37,40.5,22,24,3,21,25,75,30,1,45,26,63.4,"MF"
"Jordan Spence","2018-2019",32,18,8,44.4,10,55.6,28,16,15,9,4,13,17,76.5,4,16,5,11,18,46,41,0,54,51,51.4,"DF"
"Joey Pelupessy","2018-2019",17,4,4,100,0,0,62,42,26,34,2,13,42,31,29,22,6,16,40,102,44,0,28,44,38.9,"MF"
"Omar Richards","2018-2019",38,16,11,68.8,5,31.3,25,16,12,12,1,9,13,69.2,4,10,3,7,10,35,21,0,4,17,19,"DF,FW"
"David Nugent","2018-2019",103,6,3,50,3,50,15,7,2,11,2,2,4,50,2,10,2,8,2,17,15,0,49,93,34.5,"FW"
"Mahlon Romeo","2018-2019",91,44,24,54.5,20,45.5,61,40,45,13,3,21,38,55.3,17,42,14,28,39,100,152,0,51,54,48.6,"DF"
"Jordan Storey","2018-2019",1,2,1,50,1,50,20,15,14,6,0,8,13,61.5,5,19,14,5,41,61,148,1,134,93,59,"DF"
"Jefferson Montero","2018-2019",68,42,22,52.4,20,47.6,4,4,4,0,0,0,1,0,1,1,0,1,0,4,0,0,2,6,25,"FW"
"Hal Robson-Kanu","2018-2019",157,48,29,60.4,19,39.6,6,2,0,4,2,0,5,0,5,11,1,10,3,9,8,0,24,51,32,"FW"
"Andrew Taylor","2018-2019",34,10,7,70,3,30,21,16,10,10,1,6,23,26.1,17,35,13,22,23,44,93,2,34,35,49.3,"DF"
"Luke Murphy","2018-2019",3,5,4,80,1,20,11,7,2,8,1,4,14,28.6,10,9,1,8,10,21,8,0,8,10,44.4,"MF"
"Will Keane","2018-2019",51,9,5,55.6,4,44.4,14,13,1,7,6,0,7,0,7,8,2,6,2,16,16,0,43,93,31.6,"FW"
"Conor Hourihane","2018-2019",98,11,8,72.7,3,27.3,58,35,28,27,3,22,49,44.9,27,28,8,20,20,78,59,1,28,21,57.1,"MF"
"Joe Nuttall","2018-2019",40,5,3,60,2,40,4,2,3,1,0,2,3,66.7,1,4,0,4,0,4,6,0,34,63,35.1,"FW"
"Ryan Leonard","2018-2019",38,16,7,43.8,9,56.3,72,49,35,32,5,30,59,50.8,29,46,15,31,45,117,68,0,82,84,49.4,"MF,FW"
"Chris Mepham","2018-2019",3,9,8,88.9,1,11.1,27,21,18,9,0,15,21,71.4,6,21,17,4,35,62,95,1,75,61,55.1,"DF"
"Kevin Stewart","2018-2019",13,25,20,80,5,20,75,43,30,43,2,24,63,38.1,39,41,8,33,47,122,34,0,34,21,61.8,"MF"
"Filippo Costa","2020-2021",60,29,14,48.3,15,51.7,17,13,8,6,3,4,13,30.8,9,17,5,12,26,43,48,0,25,14,64.1,"DF"
"Luca Ravanelli","2020-2021",2,3,3,100,0,0,37,28,23,12,2,17,25,68,8,25,12,13,37,74,92,0,57,44,56.4,"DF"
"Daniele Dessena","2020-2021",62,25,14,56,11,44,32,17,12,16,4,9,26,34.6,17,25,6,19,33,65,29,0,29,40,42,"MF"
"Raffaele Maiello","2020-2021",43,53,34,64.2,19,35.8,65,43,35,26,4,18,39,46.2,21,24,4,20,53,118,65,0,14,25,35.9,"MF"
"Matteo Bruscagin","2020-2021",65,13,5,38.5,8,61.5,34,24,23,8,3,19,40,47.5,21,33,9,24,37,71,62,0,49,35,58.3,"DF"
"Michele Camporese","2020-2021",7,1,1,100,0,0,12,7,10,1,1,3,7,42.9,4,36,28,8,40,52,120,0,66,41,61.7,"DF"
"Simone Muratore","2020-2021",29,28,19,67.9,9,32.1,40,25,26,9,5,17,33,51.5,16,19,4,15,20,60,26,0,12,24,33.3,"MF"
"Yao Eloge Koffi","2020-2021",9,2,1,50,1,50,21,14,16,4,1,6,11,54.5,5,11,7,4,13,34,24,0,7,7,50,"DF"
"Frank Tsadjout","2020-2021",139,30,17,56.7,13,43.3,15,6,1,10,4,1,6,16.7,5,20,2,18,5,20,10,0,99,99,50,"FW"
"Marco D'Alessandro","2020-2021",114,51,28,54.9,23,45.1,17,11,7,9,1,3,7,42.9,4,14,4,10,11,28,13,0,2,10,16.7,"DF,MF"
"Mario Šitum","2020-2021",71,23,14,60.9,9,39.1,22,13,13,9,0,6,11,54.5,5,16,4,12,13,35,23,0,10,19,34.5,"FW,DF"
"Romano Perticone","2020-2021",8,7,4,57.1,3,42.9,31,25,19,11,1,12,24,50,12,17,10,7,36,67,75,0,97,33,74.6,"DF"
"Gabriel Cleur","2020-2021",35,30,21,70,9,30,36,25,21,9,6,21,35,60,14,17,6,11,32,68,35,0,16,18,47.1,"DF"
"Leonardo Capezzi","2020-2021",57,31,19,61.3,12,38.7,53,35,24,24,5,15,37,40.5,22,35,3,32,14,67,27,1,27,32,45.8,"MF"
"Lorenzo Del Pinto","2020-2021",8,6,2,33.3,4,66.7,27,13,12,11,4,8,25,32,17,20,3,17,15,42,20,0,17,21,44.7,"MF"
"Mattia Aramu","2020-2021",166,27,12,44.4,15,55.6,19,13,6,10,3,8,29,27.6,21,17,3,14,13,32,9,0,10,26,27.8,"MF,FW"
"Pietro Iemmello","2020-2021",65,20,8,40,12,60,5,1,0,2,3,1,4,25,3,5,1,4,0,5,3,0,16,25,39,"FW"
"Gabriele Corbo","2020-2021",12,5,0,0,5,100,10,4,7,2,1,7,9,77.8,2,9,7,2,14,24,31,0,9,16,36,"DF"
"Davide Mazzocco","2020-2021",37,14,7,50,7,50,23,17,12,8,3,11,22,50,11,18,3,15,8,31,10,0,26,23,53.1,"MF"
"Fabiano Parisi","2020-2021",83,67,40,59.7,27,40.3,30,17,15,10,5,8,22,36.4,14,24,3,21,26,56,37,0,14,15,48.3,"DF"
"Danilo Soddimo","2020-2021",54,32,16,50,16,50,11,9,5,4,2,2,8,25,6,7,0,7,6,17,4,1,11,18,37.9,"MF,FW"
"Michele Pellizzer","2020-2021",1,3,2,66.7,1,33.3,11,10,7,4,0,3,7,42.9,4,20,11,9,22,33,81,0,42,42,50,"DF"
"Alessandro De Vitis","2020-2021",13,8,6,75,2,25,26,13,13,9,4,11,18,61.1,7,20,12,8,42,68,61,1,65,39,62.5,"MF,DF"
"Fabrizio Poli","2020-2021",5,2,1,50,1,50,16,9,11,5,0,5,13,38.5,8,25,19,6,41,57,114,1,80,40,66.7,"DF"
"Norbert Gyömbér","2020-2021",1,7,7,100,0,0,49,34,38,7,4,26,41,63.4,15,50,36,14,52,101,235,2,97,41,70.3,"DF"
"Marco Sala","2020-2021",160,27,13,48.1,14,51.9,50,24,32,9,9,26,47,55.3,21,33,5,28,25,75,33,0,9,21,30,"DF"
"Augustus Kargbo","2020-2021",119,26,8,30.8,18,69.2,3,3,1,1,1,0,3,0,3,12,2,10,3,6,1,0,4,34,10.5,"FW"
"Stefano Sabelli","2020-2021",84,24,12,50,12,50,78,53,41,28,9,42,66,63.6,24,42,10,32,41,119,66,0,21,15,58.3,"DF"
"Enrico Baldini","2020-2021",52,20,7,35,13,65,8,6,5,3,0,2,10,20,8,5,0,5,1,9,6,0,3,8,27.3,"MF,FW"
"Alessio Vita","2020-2021",104,31,14,45.2,17,54.8,26,15,11,9,6,11,25,44,14,16,3,13,20,46,13,0,19,39,32.8,"MF,DF"
"Abou-Malal Ba","2020-2021",5,8,6,75,2,25,19,17,9,8,2,10,15,66.7,5,13,5,8,13,32,13,0,6,9,40,"MF"
"Alessio Tribuzzi","2020-2021",113,34,23,67.6,11,32.4,16,8,8,5,3,7,13,53.8,6,7,1,6,4,20,13,0,5,16,23.8,"MF,FW"
"Samuele Longo","2020-2021",66,29,13,44.8,16,55.2,12,7,2,5,5,3,7,42.9,4,9,1,8,1,13,12,0,25,59,29.8,"FW"
"Lorenzo Dickmann","2020-2021",156,41,16,39,25,61,60,32,36,19,5,35,50,70,15,21,2,19,29,89,41,2,9,18,33.3,"DF"
"Emanuele Padella","2020-2021",3,2,2,100,0,0,28,19,19,9,0,16,21,76.2,5,33,21,12,52,80,108,0,55,50,52.4,"DF"
"Tomasz Kupisz","2020-2021",112,20,10,50,10,50,33,23,16,12,5,16,38,42.1,22,25,6,19,22,55,27,0,28,28,50,"MF,DF"
"Dimitri Bisoli","2020-2021",124,18,9,50,9,50,48,27,15,26,7,21,43,48.8,22,55,13,42,29,77,41,0,36,40,47.4,"MF"
"Karlo Butić","2020-2021",137,35,14,40,21,60,4,2,1,1,2,1,11,9.1,10,10,2,8,8,12,8,0,25,50,33.3,"FW"
"Roberto Zammarini","2020-2021",103,17,7,41.2,10,58.8,57,34,24,23,10,33,63,52.4,30,34,5,29,14,71,39,0,21,30,41.2,"MF"
"Riccardo Idda","2020-2021",4,3,3,100,0,0,33,21,25,7,1,15,27,55.6,12,38,30,8,62,95,154,0,92,69,57.1,"DF"
"Davide Petrucci","2020-2021",14,30,21,70,9,30,61,35,28,26,7,20,50,40,30,30,7,23,41,102,38,0,46,21,68.7,"MF"
"Michele Marconi","2020-2021",139,7,5,71.4,2,28.6,4,4,0,2,2,1,3,33.3,2,8,0,8,4,8,28,1,179,100,64.2,"FW"
"Ettore Gliozzi","2020-2021",101,24,13,54.2,11,45.8,14,6,3,6,5,7,15,46.7,8,8,2,6,5,19,30,0,84,87,49.1,"FW"
"Amato Ciciretti","2020-2021",155,33,19,57.6,14,42.4,38,20,20,10,8,13,38,34.2,25,20,2,18,13,51,5,0,4,14,22.2,"MF,FW"
"Alberto Barison","2020-2021",5,2,2,100,0,0,24,13,20,4,0,6,11,54.5,5,19,17,2,39,63,97,0,58,49,54.2,"DF"
"Oliver Kragl","2020-2021",49,15,9,60,6,40,35,24,29,5,1,21,36,58.3,15,22,4,18,33,68,45,0,14,15,48.3,"DF"
"Cristian Molinaro","2020-2021",30,6,3,50,3,50,18,10,14,3,1,6,7,85.7,1,7,1,6,25,43,31,0,14,11,56,"DF"
"Andrea Settembrini","2020-2021",39,18,7,38.9,11,61.1,24,14,7,15,2,8,23,34.8,15,27,4,23,12,36,16,0,16,25,39,"MF"
"Luca Siligardi","2020-2021",34,14,9,64.3,5,35.7,7,5,4,1,2,5,10,50,5,12,1,11,11,18,3,0,3,12,20,"FW,MF"
"Luca Garritano","2020-2021",230,76,38,50,38,50,41,25,16,20,5,18,55,32.7,37,42,5,37,38,79,28,1,16,42,27.6,"MF,FW"
"Pablo Rodríguez","2020-2021",78,27,12,44.4,15,55.6,8,5,0,4,4,3,8,37.5,5,7,0,7,4,12,0,0,5,16,23.8,"FW"
"Bruno Martella","2020-2021",151,34,17,50,17,50,19,9,10,7,2,8,22,36.4,14,14,3,11,44,63,69,0,29,22,56.9,"DF"
"Biagio Meccariello","2020-2021",4,6,4,66.7,2,33.3,39,26,24,13,2,17,23,73.9,6,34,15,19,84,123,116,3,107,37,74.3,"DF"
"Federico Di Francesco","2020-2021",183,46,28,60.9,18,39.1,8,6,1,6,1,3,13,23.1,10,8,1,7,6,14,0,0,9,15,37.5,"FW,MF"
"Samuele Birindelli","2020-2021",114,40,22,55,18,45,37,25,16,13,8,18,36,50,18,25,3,22,33,70,81,0,19,31,38,"DF"
"Walter López","2020-2021",19,5,3,60,2,40,17,13,11,6,0,9,17,52.9,8,13,7,6,19,36,47,0,21,19,52.5,"DF"
"Jakub Łabojko","2020-2021",24,12,6,50,6,50,28,16,15,10,3,12,35,34.3,23,13,4,9,25,53,19,1,14,17,45.2,"MF"
"Camillo Ciano","2020-2021",120,23,15,65.2,8,34.8,19,10,8,8,3,4,21,19,17,14,1,13,3,22,4,0,11,27,28.9,"FW"
"Alessandro Salvi","2020-2021",83,34,21,61.8,13,38.2,29,20,11,15,3,17,29,58.6,12,29,13,16,33,62,46,0,53,38,58.2,"DF"
"Francesco Margiotta","2020-2021",76,21,12,57.1,9,42.9,11,9,2,6,3,3,15,20,12,5,0,5,2,13,3,0,2,29,6.5,"FW"
"Giulio Donati","2020-2021",127,13,5,38.5,8,61.5,37,28,21,10,6,19,29,65.5,10,20,5,15,47,84,59,0,22,17,56.4,"DF"
"Massimo Bertagnoli","2020-2021",46,17,10,58.8,7,41.2,27,16,11,13,3,8,20,40,12,27,5,22,18,45,20,0,19,19,50,"DF,MF"
"Fabrizio Caligara","2020-2021",24,22,14,63.6,8,36.4,31,16,17,12,2,13,34,38.2,21,28,1,27,25,56,18,0,8,5,61.5,"MF"
"Domen Črnigoj","2020-2021",64,26,15,57.7,11,42.3,27,13,11,13,3,4,12,33.3,8,17,3,14,19,46,11,0,15,16,48.4,"MF"
"Matteo Mancosu","2020-2021",59,8,6,75,2,25,6,4,3,3,0,1,9,11.1,8,6,2,4,2,8,11,0,22,47,31.9,"FW"
"Stefano Pettinari","2020-2021",107,25,12,48,13,52,4,2,1,1,2,2,11,18.2,9,9,1,8,2,6,2,0,14,19,42.4,"FW"
"Leonard Zuta","2020-2021",49,8,4,50,4,50,27,15,15,11,1,12,17,70.6,5,23,6,17,32,59,28,0,20,29,40.8,"DF"
"Bright Gyamfi","2020-2021",7,14,10,71.4,4,28.6,46,26,26,20,0,17,26,65.4,9,20,11,9,46,92,45,1,23,13,63.9,"DF"
"Cosimo Chiricò","2020-2021",113,55,39,70.9,16,29.1,9,6,3,5,1,4,12,33.3,8,8,0,8,9,18,0,1,1,14,6.7,"FW,MF"
"Andrea Danzi","2020-2021",8,10,6,60,4,40,11,8,4,7,0,1,3,33.3,2,2,0,2,16,27,4,0,0,2,0,"MF"
"Vlad Dragomir","2020-2021",20,15,6,40,9,60,27,17,18,8,1,6,27,22.2,21,19,4,15,20,47,31,0,15,14,51.7,"MF"
"Kevin Biondi","2020-2021",24,6,4,66.7,2,33.3,9,6,5,3,1,3,8,37.5,5,7,0,7,7,16,7,0,7,15,31.8,"MF,DF"
"Tom van de Looi","2020-2021",29,11,7,63.6,4,36.4,45,27,20,22,3,17,32,53.1,15,26,14,12,22,67,54,1,38,27,58.5,"MF"
"Marco Rosafio","2020-2021",106,22,10,45.5,12,54.5,4,1,2,1,1,1,5,20,4,5,0,5,6,10,0,0,13,28,31.7,"MF,FW"
"Davide Frattesi","2020-2021",148,83,45,54.2,38,45.8,59,41,30,23,6,26,52,50,26,36,7,29,22,81,24,2,21,27,43.8,"MF"
"Grigoris Kastanos","2020-2021",87,39,23,59,16,41,60,35,19,35,6,25,53,47.2,28,29,3,26,32,92,21,0,42,34,55.3,"MF"
"Luca Valzania","2020-2021",122,43,26,60.5,17,39.5,66,45,14,37,15,22,68,32.4,46,50,4,46,61,127,42,0,54,40,57.4,"MF,FW"
"Daniele Donnarumma","2020-2021",77,34,23,67.6,11,32.4,56,34,29,18,9,27,42,64.3,15,28,5,23,41,97,45,1,30,31,49.2,"DF"
"Luca Strizzolo","2020-2021",89,15,7,46.7,8,53.3,18,8,7,5,6,5,11,45.5,6,18,3,15,7,25,13,0,69,61,53.1,"FW"
"Marco Mancosu","2020-2021",194,42,26,61.9,16,38.1,20,10,3,10,7,7,24,29.2,17,13,2,11,14,34,6,0,16,17,48.5,"MF"
"Luca Bittante","2020-2021",83,17,9,52.9,8,47.1,18,16,9,5,4,10,19,52.6,9,15,5,10,15,33,30,0,21,36,36.8,"DF,MF"
"Mirko Bruccini","2020-2021",9,2,2,100,0,0,10,6,5,4,1,5,12,41.7,7,9,2,7,9,19,12,0,4,7,36.4,"MF"
"Riccardo Meggiorini","2020-2021",130,37,23,62.2,14,37.8,12,8,0,7,5,1,3,33.3,2,16,3,13,4,16,17,0,102,96,51.5,"FW"
"Davide Bettella","2020-2021",3,4,3,75,1,25,15,8,11,3,1,5,8,62.5,3,17,7,10,31,46,82,3,33,21,61.1,"DF"
"Marcel Büchel","2020-2021",13,18,9,50,9,50,36,21,19,14,3,12,34,35.3,22,22,9,13,63,99,47,1,45,33,57.7,"MF"
"Gaetano Masucci","2020-2021",34,3,0,0,3,100,10,6,2,7,1,4,11,36.4,7,5,1,4,8,18,6,0,22,24,47.8,"FW,MF"
"Raffaele Pucino","2020-2021",71,17,11,64.7,6,35.3,52,28,39,12,1,31,43,72.1,12,24,13,11,43,95,82,0,36,26,58.1,"DF"
"Leonardo Mancuso","2020-2021",235,38,18,47.4,20,52.6,8,3,1,5,2,4,19,21.1,15,19,1,18,7,15,12,0,41,68,37.6,"FW"
"Christian Maggio","2020-2021",75,26,13,50,13,50,28,17,17,10,1,11,25,44,14,18,4,14,18,46,37,0,15,17,46.9,"DF"
"Riccardo Brosco","2020-2021",0,3,3,100,0,0,20,11,12,7,1,4,10,40,6,42,31,11,52,72,181,1,122,73,62.6,"DF"
"Luca Zamparo","2020-2021",92,20,8,40,12,60,8,5,0,3,5,1,6,16.7,5,14,3,11,2,10,14,0,47,59,44.3,"FW"
"Andrea Barberis","2020-2021",20,7,6,85.7,1,14.3,39,26,20,16,3,15,33,45.5,18,24,5,19,37,76,29,0,16,25,39,"MF"
"Simone Missiroli","2020-2021",30,8,2,25,6,75,33,23,16,14,3,10,34,29.4,24,25,8,17,48,81,44,0,61,46,57,"MF"
"Massimiliano Mangraviti","2020-2021",5,4,4,100,0,0,25,14,20,5,0,11,20,55,9,42,31,11,41,66,106,0,56,33,62.9,"DF"
"Francesco Di Mariano","2020-2021",164,27,12,44.4,15,55.6,20,15,10,6,4,10,22,45.5,12,20,2,18,16,36,13,0,15,17,46.9,"FW,MF"
"Mattia Viviani","2020-2021",12,26,22,84.6,4,15.4,55,32,23,26,6,13,41,31.7,28,36,2,34,23,78,19,0,21,33,38.9,"MF"
"Salvatore Pezzella","2020-2021",10,12,10,83.3,2,16.7,10,5,7,3,0,6,13,46.2,7,5,0,5,6,16,2,0,7,6,53.8,"MF"
"Marco Crimi","2020-2021",48,24,11,45.8,13,54.2,58,41,26,27,5,18,49,36.7,31,22,6,16,32,90,20,0,22,18,55,"MF"
"Marco Fossati","2020-2021",2,2,2,100,0,0,18,12,12,5,1,11,22,50,11,6,1,5,9,27,8,1,7,5,58.3,"MF"
"Pietro Beruatto","2020-2021",68,37,13,35.1,24,64.9,46,30,27,16,3,23,31,74.2,8,35,4,31,31,77,56,0,31,26,54.4,"DF"
"Luca Palmiero","2020-2021",46,24,8,33.3,16,66.7,87,50,28,51,8,50,116,43.1,66,34,2,32,51,138,40,0,18,18,50,"MF"
"Gianluca Gaetano","2020-2021",165,62,34,54.8,28,45.2,23,17,5,12,6,8,28,28.6,20,24,1,23,12,35,12,0,20,39,33.9,"MF,FW"
"Germán Denis","2020-2021",75,20,13,65,7,35,11,9,6,3,2,3,9,33.3,6,3,0,3,4,15,24,0,72,61,54.1,"FW"
"Kyle Lafferty","2020-2021",20,5,3,60,2,40,2,0,0,0,2,0,2,0,2,5,2,3,1,3,7,0,16,19,45.7,"FW"
"Jacopo Segre","2020-2021",61,20,11,55,9,45,31,18,11,17,3,16,27,59.3,11,13,1,12,15,46,15,0,17,20,45.9,"MF"
"Aleksa Terzić","2020-2021",80,39,20,51.3,19,48.7,33,19,25,7,1,20,36,55.6,16,22,5,17,30,63,37,0,16,19,45.7,"DF"
"Nicolò Casale","2020-2021",17,3,2,66.7,1,33.3,35,23,21,11,3,14,20,70,6,23,8,15,30,65,69,1,55,48,53.4,"DF"
"Luca Ghiringhelli","2020-2021",60,5,2,40,3,60,29,16,12,10,7,10,18,55.6,8,36,7,29,35,64,70,0,20,22,47.6,"DF"
"Marcos Curado","2020-2021",0,7,5,71.4,2,28.6,25,18,21,4,0,10,14,71.4,4,22,16,6,27,52,51,0,48,20,70.6,"DF"
"Milan Đurić","2020-2021",135,14,13,92.9,1,7.1,13,7,1,6,6,3,6,50,3,12,2,10,4,17,36,0,338,94,78.2,"FW"
"Andrea Papetti","2020-2021",1,3,3,100,0,0,20,10,15,5,0,13,22,59.1,9,20,17,3,21,41,51,0,19,23,45.2,"DF"
"Jérémy Ménez","2020-2021",109,37,20,54.1,17,45.9,14,7,2,9,3,5,11,45.5,6,8,1,7,3,17,1,0,2,3,40,"FW,MF"
"Nicola Pasini","2020-2021",0,1,1,100,0,0,20,14,15,5,0,9,18,50,9,18,11,7,32,52,67,0,61,43,58.7,"DF"
"Tomi Petrović","2020-2021",28,8,4,50,4,50,2,0,1,0,1,0,0,NA,0,4,0,4,1,3,6,0,16,28,36.4,"FW,MF"
"Luca Mora","2020-2021",62,13,6,46.2,7,53.8,15,7,4,8,3,5,16,31.3,11,13,4,9,11,26,19,0,35,18,66,"MF"
"Mohamed Bahlouli","2020-2021",38,37,24,64.9,13,35.1,15,10,5,7,3,5,14,35.7,9,10,1,9,7,22,6,0,7,16,30.4,"MF"
"Antonio Di Gaudio","2020-2021",47,17,6,35.3,11,64.7,8,2,2,5,1,4,8,50,4,7,1,6,2,10,3,0,2,8,20,"MF,FW"
"Andrea Beghetto","2020-2021",129,17,5,29.4,12,70.6,15,9,11,4,0,10,17,58.8,7,18,2,16,17,32,38,1,1,10,9.1,"DF"
"Federico Proia","2020-2021",117,43,23,53.5,20,46.5,84,53,26,42,16,37,88,42,51,54,7,47,28,112,35,0,39,50,43.8,"MF"
"Antonio Vacca","2020-2021",3,12,7,58.3,5,41.7,21,11,8,12,1,9,24,37.5,15,6,2,4,21,42,23,0,6,8,42.9,"MF"
"Nicola Pavan","2020-2021",21,6,4,66.7,2,33.3,44,22,18,23,3,19,34,55.9,15,29,7,22,38,82,37,0,49,44,52.7,"MF"
"Giuseppe Sibilli","2020-2021",99,30,18,60,12,40,12,9,7,2,3,0,5,0,5,8,0,8,2,14,5,0,8,16,33.3,"FW,MF"
"Thiago Cionek","2020-2021",3,4,2,50,2,50,31,24,22,6,3,11,22,50,11,32,23,9,58,89,116,0,77,51,60.2,"DF"
"Ivan Lakićević","2020-2021",35,13,8,61.5,5,38.5,8,6,3,4,1,5,8,62.5,3,10,6,4,14,22,25,0,9,4,69.2,"DF"
"Tasos Avlonitis","2020-2021",1,1,1,100,0,0,17,13,14,3,0,7,8,87.5,1,13,6,7,35,52,74,0,33,23,58.9,"DF"
"Mauro Coppolaro","2020-2021",22,13,12,92.3,1,7.7,23,18,17,6,0,13,21,61.9,8,18,9,9,23,46,45,0,24,25,49,"DF"
"Emanuele Ndoj","2020-2021",37,14,9,64.3,5,35.7,19,13,10,3,6,3,16,18.8,13,9,4,5,2,21,5,0,9,8,52.9,"MF"
"Abdelhamid Sabiri","2020-2021",104,90,45,50,45,50,62,36,21,33,8,15,46,32.6,31,33,3,30,25,87,14,0,54,56,49.1,"MF,FW"
"Francesco De Rose","2020-2021",3,7,7,100,0,0,21,10,11,9,1,7,15,46.7,8,5,1,4,7,28,7,0,0,1,0,"MF"
"Riad Bajić","2020-2021",197,37,20,54.1,17,45.9,6,5,0,3,3,2,4,50,2,9,2,7,8,14,10,0,44,115,27.7,"FW"
"Igor Radrezza","2020-2021",153,58,38,65.5,20,34.5,26,19,9,15,2,16,38,42.1,22,19,2,17,20,46,10,0,18,43,29.5,"MF"
"Alessandro Quaini","2020-2021",2,5,1,20,4,80,7,5,6,1,0,3,7,42.9,4,5,2,3,11,18,2,0,8,8,50,"MF"
"Andrea Schiavone","2020-2021",16,10,6,60,4,40,19,14,6,11,2,8,33,24.2,25,18,4,14,27,46,26,1,6,10,37.5,"MF"
"Mirko Carretta","2020-2021",245,61,26,42.6,35,57.4,8,4,2,5,1,4,14,28.6,10,6,0,6,7,15,2,0,8,34,19,"FW"
"Emanuele Cicerelli","2020-2021",80,71,42,59.2,29,40.8,23,14,7,13,3,11,30,36.7,19,14,0,14,14,37,9,1,7,12,36.8,"MF,DF"
"Enrico Del Prato","2020-2021",48,7,2,28.6,5,71.4,28,18,20,6,2,13,19,68.4,6,38,14,24,47,75,73,0,46,49,48.4,"DF"
"Massimo Coda","2020-2021",316,73,48,65.8,25,34.2,12,7,2,1,9,2,16,12.5,14,10,0,10,8,20,15,1,72,120,37.5,"FW"
"Youssef Maleh","2020-2021",102,22,13,59.1,9,40.9,45,28,18,21,6,12,26,46.2,14,42,5,37,24,69,26,0,18,30,37.5,"MF"
"Fabio Ceravolo","2020-2021",53,7,6,85.7,1,14.3,4,1,3,0,1,2,4,50,2,0,0,0,2,6,3,0,8,26,23.5,"FW,MF"
"Filip Jagiełło","2020-2021",165,36,22,61.1,14,38.9,20,14,6,13,1,8,18,44.4,10,18,1,17,13,33,11,0,14,38,26.9,"MF"
"Pietro Ceccaroni","2020-2021",6,15,11,73.3,4,26.7,21,12,17,4,0,8,13,61.5,5,47,31,16,47,68,176,1,80,43,65,"DF"
"Luca Rigoni","2020-2021",21,12,8,66.7,4,33.3,33,23,19,11,3,12,26,46.2,14,15,6,9,38,71,30,0,36,43,45.6,"MF"
"Szymon Żurkowski","2020-2021",78,31,16,51.6,15,48.4,32,16,12,13,7,14,29,48.3,15,28,3,25,20,52,15,0,12,19,38.7,"MF"
"Angelo Corsi","2020-2021",85,15,7,46.7,8,53.3,65,38,43,16,6,34,57,59.6,23,25,5,20,21,86,30,0,13,17,43.3,"DF"
"Mario Gargiulo","2020-2021",118,20,6,30,14,70,26,15,13,8,5,11,21,52.4,10,24,3,21,14,40,25,0,43,49,46.7,"MF"
"Alessandro Marotta","2020-2021",41,10,5,50,5,50,2,2,0,1,1,0,4,0,4,8,1,7,1,3,2,0,18,26,40.9,"FW"
"Riccardo Bocalon","2020-2021",48,11,5,45.5,6,54.5,4,2,2,2,0,0,2,0,2,9,0,9,2,6,9,0,34,49,41,"FW"
"Agostino Camigliano","2020-2021",5,1,1,100,0,0,16,10,7,8,1,6,14,42.9,8,9,5,4,15,31,49,2,34,20,63,"DF"
"Nicolò Brighenti","2020-2021",11,4,4,100,0,0,38,28,17,20,1,19,31,61.3,12,31,17,14,65,103,98,1,37,23,61.7,"DF"
"Riccardo Martinelli","2020-2021",5,5,2,40,3,60,19,14,12,7,0,4,11,36.4,7,17,9,8,53,72,52,0,46,14,76.7,"DF"
"Alfredo Donnarumma","2020-2021",110,14,8,57.1,6,42.9,5,1,1,0,4,3,16,18.8,13,5,0,5,9,14,1,0,20,32,38.5,"FW,MF"
"Fabio Maistro","2020-2021",126,81,41,50.6,40,49.4,25,13,12,10,3,8,25,32,17,14,1,13,6,31,10,0,10,24,29.4,"MF,FW"
"Valerio Mantovani","2020-2021",1,1,1,100,0,0,12,9,10,2,0,6,10,60,4,18,14,4,25,37,43,0,24,13,64.9,"DF"
"Fabio Pisacane","2020-2021",2,2,1,50,1,50,9,3,9,0,0,5,6,83.3,1,9,4,5,6,15,28,0,12,20,37.5,"DF"
"Lucas Castro","2020-2021",50,28,17,60.7,11,39.3,7,5,2,4,1,1,11,9.1,10,6,0,6,5,12,7,0,6,7,46.2,"MF"
"Nicola Dalmonte","2020-2021",115,36,17,47.2,19,52.8,19,15,7,9,3,5,16,31.3,11,18,1,17,19,38,7,0,2,19,9.5,"MF,FW"
"Anderson Lima","2020-2021",30,36,20,55.6,16,44.4,23,15,11,9,3,8,27,29.6,19,23,1,22,7,30,1,0,9,10,47.4,"MF,FW"
"Vasile Mogos","2020-2021",201,32,14,43.8,18,56.3,65,46,44,15,6,40,64,62.5,24,41,8,33,49,114,81,1,63,52,54.8,"DF"
"Patryk Dziczek","2020-2021",5,8,6,75,2,25,17,14,10,6,1,11,17,64.7,6,7,3,4,9,26,10,0,7,11,38.9,"MF"
"Salvatore D'Elia","2020-2021",29,4,2,50,2,50,9,6,4,4,1,3,6,50,3,8,4,4,4,13,5,0,4,4,50,"DF"
"Massimiliano Busellato","2020-2021",35,13,7,53.8,6,46.2,48,25,23,23,2,23,42,54.8,19,33,9,24,30,78,20,0,10,13,43.5,"MF"
"Salvatore Esposito","2020-2021",20,14,8,57.1,6,42.9,40,22,18,21,1,26,53,49.1,27,28,13,15,30,70,45,0,16,25,39,"MF"
"Patrick Ciurria","2020-2021",253,82,46,56.1,36,43.9,21,10,6,7,8,6,21,28.6,15,36,3,33,6,27,16,0,23,52,30.7,"FW,MF"
"Marko Pajač","2020-2021",51,11,7,63.6,4,36.4,6,4,3,3,0,4,10,40,6,3,1,2,6,12,9,0,4,3,57.1,"DF,MF"
"Matteo Cotali","2020-2021",49,8,3,37.5,5,62.5,16,8,14,2,0,6,12,50,6,11,3,8,7,23,23,0,7,13,35,"DF"
"Paolo Bartolomei","2020-2021",28,7,5,71.4,2,28.6,14,7,8,5,1,9,20,45,11,6,2,4,12,26,8,1,4,13,23.5,"MF"
"Marco Capuano","2020-2021",1,7,6,85.7,1,14.3,8,4,8,0,0,2,6,33.3,4,7,5,2,8,16,46,0,42,32,56.8,"DF"
"Marco Toscano","2020-2021",12,5,2,40,3,60,10,6,5,5,0,4,11,36.4,7,6,1,5,6,16,3,0,3,5,37.5,"MF"
"Andrea Colpani","2020-2021",84,37,18,48.6,19,51.4,12,9,2,8,2,5,12,41.7,7,12,4,8,7,19,9,0,8,13,38.1,"MF"
"Giuseppe De Luca","2020-2021",129,27,14,51.9,13,48.1,15,7,6,5,4,8,33,24.2,25,13,0,13,2,17,4,0,18,57,24,"FW,MF"
"Marco Calderoni","2020-2021",61,6,2,33.3,4,66.7,9,8,7,2,0,9,15,60,6,13,5,8,15,24,21,0,4,8,33.3,"DF"
"Andrea Nalini","2020-2021",52,18,7,38.9,11,61.1,5,2,3,1,1,2,7,28.6,5,7,0,7,3,8,9,0,30,20,60,"MF,FW"
"Dennis Johnsen","2020-2021",174,101,44,43.6,57,56.4,16,11,5,7,4,8,28,28.6,20,14,1,13,8,24,7,0,17,19,47.2,"FW,MF"
"Filippo Scaglia","2020-2021",0,1,0,0,1,100,10,4,8,2,0,7,11,63.6,4,23,12,11,17,27,26,0,34,15,69.4,"DF"
"Alessandro Vogliacco","2020-2021",19,12,5,41.7,7,58.3,52,34,33,16,3,23,38,60.5,15,23,10,13,65,117,92,1,44,42,51.2,"DF"
"Frederik Sørensen","2020-2021",1,3,1,33.3,2,66.7,11,8,6,5,0,5,9,55.6,4,12,4,8,19,30,49,0,27,17,61.4,"DF"
"Gianluca Di Chiara","2020-2021",116,34,10,29.4,24,70.6,59,37,40,14,5,29,48,60.4,19,38,11,27,38,97,67,1,19,6,76,"DF"
"Ihsan Sacko","2020-2021",35,12,9,75,3,25,10,7,9,0,1,4,7,57.1,3,2,0,2,2,12,1,0,5,11,31.3,"FW,MF"
"Lorenzo Ariaudo","2020-2021",1,4,2,50,2,50,12,7,8,4,0,4,9,44.4,5,15,10,5,18,30,55,0,33,32,50.8,"DF"
"Simone Pasa","2020-2021",15,7,6,85.7,1,14.3,16,9,3,10,3,7,14,50,7,9,3,6,10,26,13,0,16,14,53.3,"MF"
"Jari Vandeputte","2020-2021",96,28,12,42.9,16,57.1,16,7,7,4,5,6,16,37.5,10,16,0,16,7,23,13,0,12,23,34.3,"MF,FW"
"Raúl Asencio","2020-2021",63,14,8,57.1,6,42.9,3,3,2,1,0,2,8,25,6,8,2,6,3,6,12,0,46,48,48.9,"FW"
"Francesco Forte","2020-2021",127,39,8,20.5,31,79.5,10,6,2,4,4,3,16,18.8,13,9,2,7,1,11,15,0,70,79,47,"FW"
"Nenad Tomović","2020-2021",19,9,8,88.9,1,11.1,37,27,24,11,2,18,27,66.7,9,30,22,8,86,123,130,0,57,42,57.6,"DF"
"Gabriele Gori","2020-2021",91,16,8,50,8,50,9,6,0,3,6,1,6,16.7,5,6,0,6,3,12,7,0,55,73,43,"FW"
"Dejan Vokič","2020-2021",26,14,8,57.1,6,42.9,8,6,6,1,1,2,18,11.1,16,6,1,5,9,17,10,0,6,4,60,"FW,MF"
"Tommaso Cassandro","2020-2021",23,11,5,45.5,6,54.5,20,15,10,6,4,8,14,57.1,6,8,3,5,10,30,21,0,9,8,52.9,"DF"
"Francesco Belli","2020-2021",27,7,5,71.4,2,28.6,19,12,12,5,2,10,12,83.3,2,16,3,13,8,27,47,1,14,13,51.9,"DF"
"Soufiane Bidaoui","2020-2021",101,49,23,46.9,26,53.1,12,8,7,4,1,4,6,66.7,2,5,0,5,5,17,0,0,5,18,21.7,"FW,MF"
"Tommaso D'Orazio","2020-2021",27,4,1,25,3,75,22,15,11,9,2,12,17,70.6,5,14,5,9,13,35,30,2,20,5,80,"DF"
"Lamin Jallow","2020-2021",98,27,13,48.1,14,51.9,13,10,5,2,6,5,10,50,5,11,0,11,1,14,6,0,13,44,22.8,"FW"
"Nahuel Valentini","2020-2021",2,1,0,0,1,100,3,2,2,1,0,1,5,20,4,7,4,3,20,23,42,0,33,19,63.5,"DF"
"Florian Ayé","2020-2021",177,27,16,59.3,11,40.7,16,7,4,7,5,3,10,30,7,28,6,22,6,22,20,0,128,186,40.8,"FW"
"Ryder Matos","2020-2021",126,15,8,53.3,7,46.7,6,3,3,2,1,3,9,33.3,6,9,2,7,2,8,4,0,9,23,28.1,"FW"
"Nicholas Siega","2020-2021",69,23,12,52.2,11,47.8,40,22,16,18,6,17,41,41.5,24,44,5,39,11,51,19,0,16,24,40,"MF"
"Stephane Omeonga","2020-2021",49,19,12,63.2,7,36.8,42,28,19,21,2,17,32,53.1,15,23,3,20,31,73,12,0,2,24,7.7,"MF,DF"
"Ben Lhassine Kone","2020-2021",13,24,16,66.7,8,33.3,27,15,17,10,0,8,26,30.8,18,14,7,7,33,60,22,0,6,8,42.9,"MF"
"Daniel Cappelletti","2020-2021",45,11,5,45.5,6,54.5,45,27,28,12,5,22,38,57.9,16,36,25,11,66,111,99,0,110,75,59.5,"DF"
"Francesco Deli","2020-2021",25,20,9,45,11,55,19,10,10,7,2,9,14,64.3,5,13,1,12,3,22,2,0,11,5,68.8,"MF,FW"
"Jens Odgaard","2020-2021",106,43,28,65.1,15,34.9,10,3,1,8,1,4,13,30.8,9,7,2,5,3,13,20,0,27,68,28.4,"FW"
"Tiago Casasola","2020-2021",121,66,39,59.1,27,40.9,71,41,46,22,3,41,74,55.4,33,38,8,30,62,133,88,0,28,31,47.5,"DF"
"Gabriele Ferrarini","2020-2021",37,11,2,18.2,9,81.8,12,9,9,1,2,4,6,66.7,2,11,2,9,20,32,30,0,17,8,68,"DF"
"Mirko Marić","2020-2021",74,8,6,75,2,25,6,5,3,1,2,4,12,33.3,8,13,0,13,3,9,3,0,28,28,50,"FW"
"Alessandro Fiordaliso","2020-2021",21,4,3,75,1,25,23,12,14,5,4,7,17,41.2,10,19,10,9,23,46,65,0,22,18,55,"DF"
"Fausto Rossi","2020-2021",26,24,16,66.7,8,33.3,35,20,18,16,1,17,31,54.8,14,19,6,13,19,54,17,0,15,7,68.2,"MF"
"Pepín","2020-2021",82,71,41,57.7,30,42.3,32,17,12,16,4,13,34,38.2,21,30,0,30,19,51,9,0,14,19,42.4,"MF,FW"
"Mariusz Stępiński","2020-2021",146,31,15,48.4,16,51.6,6,3,1,3,2,2,6,33.3,4,12,4,8,4,10,12,1,19,44,30.2,"FW"
"Stefano Moreo","2020-2021",80,21,11,52.4,10,47.6,18,9,3,13,2,4,12,33.3,8,19,5,14,13,31,27,0,48,42,53.3,"MF,FW"
"Nicholas Pierini","2020-2021",30,18,9,50,9,50,6,3,4,0,2,2,6,33.3,4,3,0,3,1,7,3,0,5,9,35.7,"FW,DF"
"Mirko Gori","2020-2021",25,13,8,61.5,5,38.5,25,11,10,12,3,10,26,38.5,16,15,2,13,18,43,25,1,7,14,33.3,"MF"
"Davide Lanzafame","2020-2021",34,12,7,58.3,5,41.7,1,0,0,1,0,0,2,0,2,4,1,3,0,1,1,0,13,24,35.1,"FW"
"Nicola Falasco","2020-2021",54,38,27,71.1,11,28.9,30,19,14,12,4,17,36,47.2,19,29,6,23,32,62,50,0,18,8,69.2,"DF"
"Cristian Galano","2020-2021",115,14,7,50,7,50,10,6,5,5,0,5,13,38.5,8,5,1,4,6,16,7,0,5,29,14.7,"FW,MF"
"Robert Gucher","2020-2021",143,77,43,55.8,34,44.2,48,30,12,25,11,22,48,45.8,26,55,8,47,26,74,28,0,33,42,44,"MF"
"Giuseppe Bellusci","2020-2021",15,5,4,80,1,20,37,26,21,14,2,18,35,51.4,17,24,12,12,42,79,103,0,71,34,67.6,"DF"
"Sebastiano Esposito","2020-2021",107,29,12,41.4,17,58.6,22,12,6,10,6,3,18,16.7,15,18,2,16,7,29,3,1,14,33,29.8,"FW"
"Ledian Memushaj","2020-2021",67,28,13,46.4,15,53.6,20,11,9,9,2,9,25,36,16,17,3,14,10,30,6,0,22,18,55,"MF"
"Brayan Vera","2020-2021",61,20,11,55,9,45,20,14,7,11,2,4,13,30.8,9,23,1,22,10,30,19,1,16,16,50,"DF"
"Andrea Tiritiello","2020-2021",14,3,1,33.3,2,66.7,35,21,24,8,3,16,25,64,9,34,20,14,32,67,101,0,71,45,61.2,"DF"
"Eros Pisano","2020-2021",10,1,1,100,0,0,7,4,5,1,1,4,8,50,4,9,3,6,7,14,21,0,21,14,60,"DF"
"Roberto Ogunseye","2020-2021",170,31,12,38.7,19,61.3,11,7,1,5,5,3,8,37.5,5,19,2,17,1,12,15,0,105,116,47.5,"FW"
"Nadir Zortea","2020-2021",88,79,38,48.1,41,51.9,27,18,15,11,1,15,33,45.5,18,20,2,18,32,59,53,1,29,35,45.3,"DF,MF"
"Antonio Cinelli","2020-2021",29,14,9,64.3,5,35.7,42,23,22,13,7,23,51,45.1,28,25,13,12,39,81,41,0,32,30,51.6,"MF"
"Jhon Chancellor","2020-2021",0,9,6,66.7,3,33.3,26,12,22,4,0,8,22,36.4,14,16,11,5,30,56,106,0,70,28,71.4,"DF"
"Paolo Rozzio","2020-2021",0,4,2,50,2,50,23,12,14,9,0,10,18,55.6,8,30,22,8,40,63,134,0,76,42,64.4,"DF"
"Rigoberto Rivas","2020-2021",135,55,26,47.3,29,52.7,22,13,13,8,1,9,18,50,9,17,3,14,8,30,7,0,30,47,39,"FW,MF"
"Daniel Boloca","2020-2021",34,23,19,82.6,4,17.4,18,11,9,8,1,7,12,58.3,5,11,0,11,6,24,7,0,8,5,61.5,"MF"
"Stefano Giacomelli","2020-2021",142,36,8,22.2,28,77.8,37,25,13,14,10,8,26,30.8,18,19,1,18,15,52,8,0,11,23,32.4,"MF,FW"
"Žan Celar","2020-2021",107,29,18,62.1,11,37.9,13,11,3,5,5,4,7,57.1,3,12,0,12,7,20,4,0,17,24,41.5,"FW,MF"
"Simone Edera","2020-2021",86,41,11,26.8,30,73.2,8,6,5,2,1,7,15,46.7,8,10,2,8,8,16,3,0,9,12,42.9,"FW,MF"
"Alessandro Bassoli","2020-2021",2,1,0,0,1,100,17,10,13,3,1,7,10,70,3,10,6,4,20,37,48,0,29,21,58,"DF"
"Simone Pontisso","2020-2021",12,13,7,53.8,6,46.2,37,28,15,18,4,14,24,58.3,10,13,2,11,31,68,17,0,29,31,48.3,"MF"
"Michael Svoboda","2020-2021",3,4,3,75,1,25,22,14,16,4,2,12,24,50,12,14,8,6,22,44,53,0,47,42,52.8,"DF"
"Gennaro Tutino","2020-2021",242,79,31,39.2,48,60.8,7,5,2,3,2,3,16,18.8,13,17,0,17,6,13,5,0,42,84,33.3,"FW"
"Davide Agazzi","2020-2021",33,9,4,44.4,5,55.6,34,20,13,17,4,11,22,50,11,13,1,12,14,48,12,1,16,18,47.1,"MF"
"Daniele Sciaudone","2020-2021",102,38,18,47.4,20,52.6,55,32,29,18,8,23,69,33.3,46,45,10,35,37,92,32,0,35,26,57.4,"MF"
"Luca Ranieri","2020-2021",16,13,8,61.5,5,38.5,21,14,12,8,1,11,17,64.7,6,26,12,14,30,51,71,1,33,31,51.6,"DF"
"Carlos Augusto","2020-2021",154,41,23,56.1,18,43.9,51,34,25,19,7,22,38,57.9,16,39,9,30,47,98,70,1,63,31,67,"DF"
"Emanuele Terranova","2020-2021",4,1,1,100,0,0,16,12,10,6,0,8,12,66.7,4,23,14,9,38,54,97,0,65,62,51.2,"DF"
"Francesco Zampano","2020-2021",191,69,34,49.3,35,50.7,57,36,31,20,6,25,31,80.6,6,26,1,25,22,79,47,0,44,35,55.7,"DF"
"Mattia Vitale","2020-2021",34,6,5,83.3,1,16.7,14,7,7,5,2,5,14,35.7,9,11,1,10,10,24,1,0,1,11,8.3,"MF"
"Caleb Okoli","2020-2021",2,6,3,50,3,50,29,20,22,7,0,14,19,73.7,5,21,11,10,46,75,56,0,39,32,54.9,"DF"
"Fabio Lucioni","2020-2021",4,22,14,63.6,8,36.4,32,23,17,14,1,7,15,46.7,8,38,30,8,64,96,137,0,93,48,66,"DF"
"Mario Balotelli","2020-2021",32,1,0,0,1,100,1,0,0,0,1,1,1,100,0,4,0,4,1,2,3,0,7,13,35,"FW"
"Orji Okwonkwo","2020-2021",44,8,5,62.5,3,37.5,3,2,0,2,1,0,1,0,1,3,0,3,1,4,0,0,9,25,26.5,"FW,MF"
"Giacomo Beretta","2020-2021",80,15,8,53.3,7,46.7,3,2,1,0,2,0,4,0,4,3,1,2,0,3,3,0,19,34,35.8,"FW"
"Luigi Canotto","2020-2021",203,58,15,25.9,43,74.1,5,4,1,4,0,4,17,23.5,13,18,1,17,5,10,5,0,3,11,21.4,"MF,FW"
"Nicolò Cambiaghi","2020-2021",40,16,8,50,8,50,10,5,5,2,3,5,14,35.7,9,11,0,11,6,16,3,0,1,6,14.3,"FW,DF"
"Christian Gytkjær","2020-2021",104,3,3,100,0,0,8,6,0,7,1,2,8,25,6,10,1,9,7,15,14,0,32,47,40.5,"FW"
"Leo Štulac","2020-2021",41,25,19,76,6,24,62,40,18,36,8,31,48,64.6,17,22,6,16,37,99,30,0,25,20,55.6,"MF"
"Marco Armellino","2020-2021",52,10,8,80,2,20,42,28,20,14,8,25,33,75.8,8,13,4,9,10,52,17,0,19,16,54.3,"MF"
"Matteo Ardemagni","2020-2021",46,5,2,40,3,60,10,7,3,5,2,3,7,42.9,4,3,1,2,2,12,18,0,34,57,37.4,"FW"
"Camillo Tavernelli","2020-2021",72,13,2,15.4,11,84.6,4,1,1,2,1,0,3,0,3,4,0,4,0,4,0,0,11,33,25,"FW,MF"
"Matteo Legittimo","2020-2021",11,10,7,70,3,30,39,26,28,9,2,13,21,61.9,8,38,15,23,43,82,105,0,27,17,61.4,"DF"
"Paweł Jaroszyński","2020-2021",72,29,12,41.4,17,58.6,52,31,27,17,8,18,36,50,18,24,6,18,38,90,65,0,39,30,56.5,"DF"
"Jacopo Da Riva","2020-2021",18,21,10,47.6,11,52.4,31,21,19,11,1,8,33,24.2,25,20,1,19,16,47,13,0,18,16,52.9,"MF"
"Daniele Liotti","2020-2021",67,21,11,52.4,10,47.6,20,9,12,6,2,7,13,53.8,6,13,1,12,14,34,26,0,26,36,41.9,"DF,FW"
"Samuele Ricci","2020-2021",102,40,16,40,24,60,36,20,16,16,4,11,18,61.1,7,26,2,24,19,55,14,0,9,13,40.9,"MF"
"Antonio Caracciolo","2020-2021",6,19,13,68.4,6,31.6,64,42,45,16,3,25,41,61,16,49,28,21,84,148,122,0,80,64,55.6,"DF"
"Filippo De Col","2020-2021",46,8,4,50,4,50,11,7,5,5,1,3,5,60,2,13,9,4,7,18,28,0,10,12,45.5,"DF"
"Alessandro Mallamo","2020-2021",63,24,4,16.7,20,83.3,25,15,9,12,4,7,19,36.8,12,14,0,14,6,31,4,0,9,22,29,"MF,FW"
"Davide Diaw","2020-2021",242,68,23,33.8,45,66.2,31,21,5,13,13,8,22,36.4,14,40,2,38,10,41,24,0,73,90,44.8,"FW"
"Przemysław Szymiński","2020-2021",2,3,2,66.7,1,33.3,28,16,13,13,2,9,16,56.3,7,27,17,10,40,68,113,0,57,63,47.5,"DF"
"Bartosz Salamon","2020-2021",4,1,1,100,0,0,14,11,9,5,0,4,8,50,4,7,4,3,11,25,56,1,31,7,81.6,"DF"
"Luca Fiordilino","2020-2021",51,22,10,45.5,12,54.5,43,20,18,13,12,18,43,41.9,25,47,7,40,53,96,34,1,22,37,37.3,"MF"
"Andrea Paolucci","2020-2021",15,32,14,43.8,18,56.3,71,45,35,32,4,24,61,39.3,37,47,13,34,43,114,40,1,21,26,44.7,"MF"
"Marco Pinato","2020-2021",78,7,4,57.1,3,42.9,20,13,4,13,3,5,15,33.3,10,19,1,18,6,26,14,0,27,22,55.1,"MF,FW"
"Nikolas Špalek","2020-2021",104,37,20,54.1,17,45.9,22,12,4,11,7,4,17,23.5,13,23,0,23,15,37,4,0,5,18,21.7,"MF,FW"
"Riccardo Fiamozzi","2020-2021",126,47,20,42.6,27,57.4,16,9,9,5,2,10,12,83.3,2,26,13,13,22,38,35,1,11,14,44,"DF"
"Marco Rossi","2020-2021",1,1,1,100,0,0,3,3,3,0,0,1,3,33.3,2,4,4,0,9,12,14,0,13,6,68.4,"DF"
"Mardochee Nzita","2020-2021",36,13,6,46.2,7,53.8,27,17,22,4,1,20,28,71.4,8,10,3,7,10,37,21,0,13,8,61.9,"DF"
"Christian Capone","2020-2021",74,21,12,57.1,9,42.9,14,8,9,3,2,8,16,50,8,9,0,9,3,17,3,0,4,16,20,"FW"
"Gianmarco Cangiano","2020-2021",84,29,16,55.2,13,44.8,14,6,5,5,4,3,10,30,7,13,0,13,5,19,3,0,7,19,26.9,"FW,MF"
"Marcin Listkowski","2020-2021",47,22,14,63.6,8,36.4,7,4,3,4,0,3,11,27.3,8,6,0,6,5,12,4,0,4,12,25,"MF,FW"
"Marius Marin","2020-2021",72,34,21,61.8,13,38.2,75,52,33,27,15,35,69,50.7,34,21,3,18,43,118,43,0,20,36,35.7,"MF"
"Antonio Balzano","2020-2021",8,14,11,78.6,3,21.4,39,30,27,11,1,21,33,63.6,12,13,6,7,18,57,30,0,6,10,37.5,"DF"
"Antonino Barillà","2020-2021",59,16,8,50,8,50,38,24,19,16,3,14,34,41.2,20,15,8,7,15,53,17,0,15,28,34.9,"MF"
"Federico Dionisi","2020-2021",180,62,32,51.6,30,48.4,13,6,3,8,2,1,11,9.1,10,19,1,18,6,19,7,0,19,52,26.8,"FW,MF"
"Andrija Novakovich","2020-2021",152,37,23,62.2,14,37.8,9,4,2,5,2,3,9,33.3,6,16,3,13,1,10,20,0,100,109,47.8,"FW"
"Lukas Spendlhofer","2020-2021",1,2,1,50,1,50,17,12,14,3,0,12,16,75,4,12,5,7,18,35,46,0,25,19,56.8,"DF"
"Gabriel Strefezza","2020-2021",154,59,29,49.2,30,50.8,45,27,23,14,8,19,38,50,19,27,4,23,18,63,11,0,19,32,37.3,"FW,DF"
"Marcello Trotta","2020-2021",47,12,3,25,9,75,9,5,1,6,2,4,7,57.1,3,2,1,1,1,10,4,0,13,19,40.6,"FW"
"Matteo Brunori","2020-2021",141,50,19,38,31,62,12,9,1,9,2,2,12,16.7,10,22,1,21,5,17,23,0,53,85,38.4,"FW"
"Michele Castagnetti","2020-2021",31,19,10,52.6,9,47.4,66,37,27,28,11,26,65,40,39,33,3,30,47,113,57,1,35,35,50,"MF"
"Nicolò Bianchi","2020-2021",73,15,5,33.3,10,66.7,34,20,14,17,3,13,33,39.4,20,29,11,18,27,61,27,0,26,34,43.3,"MF"
"Gabriel Lunetta","2020-2021",79,56,27,48.2,29,51.8,29,15,16,12,1,10,24,41.7,14,13,2,11,15,44,13,1,16,23,41,"DF,MF"
"Ľubomír Tupta","2020-2021",39,14,7,50,7,50,7,3,5,1,1,2,4,50,2,7,1,6,1,8,2,0,5,13,27.8,"FW"
"Marco Carraro","2020-2021",4,6,6,100,0,0,14,8,8,6,0,6,13,46.2,7,15,5,10,28,42,14,0,20,19,51.3,"MF"
"Daniel Ciofani","2020-2021",145,14,9,64.3,5,35.7,10,7,2,6,2,2,9,22.2,7,14,3,11,1,11,18,0,120,99,54.8,"FW"
"Samuel Gustafson","2020-2021",44,10,8,80,2,20,45,24,13,24,8,16,37,43.2,21,16,4,12,34,79,30,0,41,34,54.7,"MF"
"Sebastian Musiolik","2020-2021",108,19,6,31.6,13,68.4,14,9,2,7,5,7,12,58.3,5,13,5,8,8,22,15,0,107,98,52.2,"FW,MF"
"Luca Magnino","2020-2021",80,23,15,65.2,8,34.8,49,29,21,20,8,21,52,40.4,31,51,5,46,32,81,47,0,56,48,53.8,"MF"
"Karamoko Cissé","2020-2021",38,12,4,33.3,8,66.7,5,5,2,2,1,1,1,100,0,2,1,1,1,6,4,0,15,22,40.5,"FW"
"Gabriele Rolando","2020-2021",39,11,6,54.5,5,45.5,7,5,2,4,1,3,5,60,2,6,1,5,2,9,6,0,6,13,31.6,"DF,FW"
"Matteo Bianchetti","2020-2021",20,11,5,45.5,6,54.5,77,50,46,27,4,41,66,62.1,25,51,27,24,54,131,146,0,109,41,72.7,"DF"
"Mirko Drudi","2020-2021",1,4,3,75,1,25,16,12,13,3,0,10,15,66.7,5,5,2,3,16,32,37,0,19,12,61.3,"DF"
"Manuel Iori","2020-2021",29,8,8,100,0,0,30,16,11,17,2,11,24,45.8,13,17,7,10,28,58,22,0,46,37,55.4,"MF"
"Andrea Tabanelli","2020-2021",22,14,9,64.3,5,35.7,16,11,8,8,0,7,15,46.7,8,15,3,12,6,22,5,0,23,17,57.5,"MF"
"Marcus Rohdén","2020-2021",186,24,12,50,12,50,44,25,15,23,6,25,42,59.5,17,25,3,22,11,55,14,0,16,40,28.6,"MF"
"Francesco Di Tacchio","2020-2021",17,23,12,52.2,11,47.8,66,47,41,24,1,30,57,52.6,27,43,18,25,75,141,52,0,102,47,68.5,"MF"
"Alberto Paloschi","2020-2021",95,13,6,46.2,7,53.8,8,6,1,5,2,1,3,33.3,2,7,0,7,5,13,15,0,24,28,46.2,"FW"
"Andrea Meroni","2020-2021",4,3,3,100,0,0,10,7,7,3,0,4,8,50,4,12,8,4,20,30,43,1,32,16,66.7,"DF"
"Michele Rigione","2020-2021",11,4,2,50,2,50,23,13,17,5,1,8,13,61.5,5,28,21,7,40,63,70,1,52,39,57.1,"DF"
"Amedeo Benedetti","2020-2021",70,12,7,58.3,5,41.7,22,13,15,2,5,11,19,57.9,8,17,4,13,8,30,33,0,7,12,36.8,"DF"
"Andrea Schenetti","2020-2021",174,48,29,60.4,19,39.6,11,7,2,5,4,4,12,33.3,8,4,1,3,5,16,9,0,13,29,31,"MF,FW"
"Davide Marsura","2020-2021",95,32,18,56.3,14,43.8,11,6,3,4,4,4,9,44.4,5,1,0,1,3,14,1,0,9,16,36,"FW,MF"
"Ivan Varone","2020-2021",69,6,4,66.7,2,33.3,72,43,31,35,6,29,68,42.6,39,28,9,19,34,106,48,0,67,48,58.3,"MF"
"Žan Majer","2020-2021",91,24,15,62.5,9,37.5,54,37,24,25,5,17,36,47.2,19,36,3,33,24,78,18,0,13,24,35.1,"MF"
"Andrea D'Errico","2020-2021",71,55,26,47.3,29,52.7,14,11,2,10,2,6,17,35.3,11,12,1,11,9,23,7,0,3,12,20,"MF,FW"
"Ernesto Torregrossa","2020-2021",78,32,12,37.5,20,62.5,1,1,0,0,1,0,2,0,2,13,4,9,1,2,10,0,27,40,40.3,"FW"
"Marcos Espeche","2020-2021",5,6,3,50,3,50,20,13,11,7,2,11,20,55,9,20,13,7,10,30,42,1,20,25,44.4,"DF,MF"
"Manuel Scavone","2020-2021",62,6,5,83.3,1,16.7,36,18,9,21,6,14,35,40,21,36,9,27,20,56,42,0,44,43,50.6,"MF"
"Filippo Nardi","2020-2021",27,17,13,76.5,4,23.5,17,11,9,6,2,6,19,31.6,13,4,1,3,7,24,2,0,5,8,38.5,"MF,FW"
"Andrea La Mantia","2020-2021",131,6,2,33.3,4,66.7,10,7,1,7,2,2,6,33.3,4,12,2,10,8,18,20,0,98,50,66.2,"FW"
"Michael Folorunsho","2020-2021",102,46,23,50,23,50,31,20,11,12,8,11,42,26.2,31,38,8,30,18,49,29,0,59,81,42.1,"MF,FW"
"Mattia Valoti","2020-2021",106,53,31,58.5,22,41.5,71,38,34,24,13,19,39,48.7,20,41,5,36,39,110,19,0,68,55,55.3,"MF,FW"
"Gianmarco Ingrosso","2020-2021",1,12,6,50,6,50,31,23,24,7,0,17,28,60.7,11,27,16,11,28,59,108,0,41,32,56.2,"DF"
"John Björkengren","2020-2021",79,23,10,43.5,13,56.5,27,11,8,11,8,13,25,52,12,31,5,26,16,43,9,0,21,31,40.4,"MF"
"Lorenzo Libutti","2020-2021",99,14,10,71.4,4,28.6,49,29,37,8,4,23,37,62.2,14,21,8,13,27,76,71,1,11,28,28.2,"DF"
"Luca Barlocco","2020-2021",52,18,7,38.9,11,61.1,15,9,6,8,1,10,23,43.5,13,12,2,10,28,43,34,0,15,20,42.9,"DF"
"Mirko Valdifiori","2020-2021",12,3,2,66.7,1,33.3,30,16,19,8,3,12,32,37.5,20,23,8,15,30,60,35,0,21,22,48.8,"MF"
"Antonino Gallo","2020-2021",91,13,6,46.2,7,53.8,21,15,12,8,1,12,21,57.1,9,18,4,14,19,40,26,0,12,17,41.4,"DF"
"Piotr Parzyszek","2020-2021",73,10,7,70,3,30,8,4,2,4,2,6,15,40,9,10,2,8,6,14,16,0,50,74,40.3,"FW"
"Luca Crecco","2020-2021",80,14,6,42.9,8,57.1,16,10,8,7,1,6,16,37.5,10,11,3,8,18,34,28,0,20,22,47.6,"DF,MF"
"Mamadou Coulibaly","2020-2021",50,26,14,53.8,12,46.2,44,26,20,21,3,13,28,46.4,15,12,0,12,27,71,11,0,29,31,48.3,"MF"
"Lorenzo Pirola","2020-2021",2,2,2,100,0,0,22,14,12,9,1,14,22,63.6,8,25,13,12,27,49,39,1,32,21,60.4,"DF"
"Rodrigo Guth","2020-2021",6,7,3,42.9,4,57.1,30,18,22,7,1,11,20,55,9,28,15,13,23,53,92,0,41,29,58.6,"DF"
"Luka Bogdan","2020-2021",5,5,5,100,0,0,32,21,20,10,2,10,21,47.6,11,19,6,13,50,82,79,0,49,28,63.6,"DF"
"Marco Varnier","2020-2021",0,3,3,100,0,0,15,9,13,2,0,9,10,90,1,6,1,5,11,26,33,0,26,20,56.5,"DF"
"Gabriel Paletta","2020-2021",2,2,1,50,1,50,18,11,12,6,0,9,18,50,9,15,11,4,19,37,67,1,35,24,59.3,"DF"
"Mario Sampirisi","2020-2021",104,17,11,64.7,6,35.3,36,22,21,9,6,18,30,60,12,27,7,20,20,56,53,1,35,20,63.6,"DF"
"Gennaro Scognamiglio","2020-2021",2,4,3,75,1,25,21,14,16,3,2,14,24,58.3,10,35,27,8,26,47,87,1,68,34,66.7,"DF"
"Sofian Kiyine","2020-2021",29,30,20,66.7,10,33.3,12,8,6,5,1,4,11,36.4,7,10,1,9,11,23,1,0,9,16,36,"MF,FW"
"Simone Branca","2020-2021",144,31,16,51.6,15,48.4,77,42,31,32,14,31,71,43.7,40,51,4,47,22,99,24,0,19,31,38,"MF"
"Claud Adjapong","2020-2021",78,20,13,65,7,35,17,10,6,10,1,9,17,52.9,8,16,3,13,27,44,30,0,18,14,56.3,"DF"
"Dimitris Nikolaou","2020-2021",0,9,8,88.9,1,11.1,24,20,19,4,1,9,9,100,0,29,24,5,29,53,116,2,67,49,57.8,"DF"
"Giacomo Ricci","2020-2021",35,22,12,54.5,10,45.5,17,13,9,7,1,8,14,57.1,6,11,1,10,19,36,11,1,5,7,41.7,"DF"
"Enrico Brignola","2020-2021",39,7,2,28.6,5,71.4,3,3,0,1,2,1,4,25,3,6,0,6,3,6,1,0,6,7,46.2,"FW,MF"
"Simone Palombi","2020-2021",102,24,10,41.7,14,58.3,3,2,1,1,1,1,8,12.5,7,4,1,3,3,6,12,0,20,42,32.3,"FW"
"Karim Laribi","2020-2021",66,39,19,48.7,20,51.3,20,16,11,7,2,11,26,42.3,15,12,2,10,15,35,14,0,15,24,38.5,"MF,FW"
"Ilias Koutsoupias","2020-2021",41,19,11,57.9,8,42.1,26,19,9,13,4,11,17,64.7,6,21,5,16,18,44,24,0,22,19,53.7,"MF"
"Mirko Eramo","2020-2021",34,11,4,36.4,7,63.6,20,14,4,11,5,10,27,37,17,16,1,15,20,40,9,0,14,20,41.2,"MF"
"Giacomo Calò","2020-2021",15,16,6,37.5,10,62.5,38,21,19,18,1,13,30,43.3,17,36,11,25,21,59,26,0,8,14,36.4,"MF"
"Francesco Lisi","2020-2021",155,73,29,39.7,44,60.3,29,19,16,7,6,12,27,44.4,15,23,5,18,25,54,36,0,11,25,30.6,"DF"
"Filippo Bandinelli","2020-2021",110,31,14,45.2,17,54.8,19,8,10,6,3,10,21,47.6,11,15,4,11,13,32,14,0,6,15,28.6,"MF"
"Morten Hjulmand","2020-2021",20,19,16,84.2,3,15.8,28,19,11,16,1,9,20,45,11,16,7,9,34,62,24,0,34,20,63,"MF"
"Freddie Veseli","2020-2021",3,2,2,100,0,0,18,12,8,10,0,7,13,53.8,6,13,9,4,28,46,64,0,25,17,59.5,"DF"
"Christian D'Urso","2020-2021",127,63,36,57.1,27,42.9,34,19,9,12,13,13,26,50,13,20,1,19,13,47,5,0,6,32,15.8,"MF"
"Liam Henderson","2020-2021",221,31,17,54.8,14,45.2,23,11,8,9,6,13,28,46.4,15,26,4,22,6,29,13,0,12,20,37.5,"MF"
"Leonardo Morosini","2020-2021",64,17,9,52.9,8,47.1,7,3,0,6,1,3,12,25,9,5,1,4,2,9,2,0,10,14,41.7,"FW"
"Alessandro Capello","2020-2021",106,37,18,48.6,19,51.4,16,11,7,8,1,2,16,12.5,14,15,2,13,8,24,19,0,27,33,45,"MF,FW"
"Niccolò Giannetti","2020-2021",53,13,5,38.5,8,61.5,2,0,0,2,0,1,1,100,0,3,1,2,1,3,3,0,10,31,24.4,"FW"
"Birkir Bjarnason","2020-2021",95,27,11,40.7,16,59.3,18,11,9,7,2,6,12,50,6,25,6,19,15,33,16,0,14,25,35.9,"MF"
"Michael Fabbro","2020-2021",135,28,15,53.6,13,46.4,14,6,5,8,1,5,13,38.5,8,12,1,11,10,24,11,0,27,54,33.3,"FW"
"Luca Mazzitelli","2020-2021",60,40,25,62.5,15,37.5,78,43,30,36,12,30,75,40,45,54,9,45,72,150,65,1,80,56,58.8,"MF"
"Loris Zonta","2020-2021",73,13,7,53.8,6,46.2,31,13,11,15,5,17,21,81,4,25,1,24,11,42,19,0,5,21,19.2,"MF,DF"
"Leonardo Sernicola","2020-2021",104,25,17,68,8,32,34,21,24,9,1,11,20,55,9,27,8,19,53,87,61,0,31,29,51.7,"DF"
"Aleš Matějů","2020-2021",47,12,7,58.3,5,41.7,43,25,31,12,0,21,36,58.3,15,25,11,14,49,92,78,0,63,30,67.7,"DF"
"Sergio Floccari","2020-2021",83,22,16,72.7,6,27.3,15,9,5,5,5,2,7,28.6,5,7,4,3,6,21,10,0,30,40,42.9,"FW"
"Domenico Frare","2020-2021",0,2,1,50,1,50,22,12,15,7,0,11,16,68.8,5,18,13,5,23,45,64,0,16,25,39,"DF"
"Filip Đorđević","2020-2021",79,12,3,25,9,75,18,13,6,6,6,8,22,36.4,14,13,3,10,5,23,18,0,51,58,46.8,"FW"
"Jaime Báez","2020-2021",262,76,38,50,38,50,32,20,15,7,10,15,40,37.5,25,26,4,22,6,38,14,0,13,35,27.1,"FW,MF"
"Marco Brescianini","2020-2021",48,42,27,64.3,15,35.7,41,20,18,17,6,15,32,46.9,17,16,4,12,19,60,17,0,18,25,41.9,"MF"
"Leandro Fernandes","2020-2021",4,12,8,66.7,4,33.3,12,6,5,7,0,3,9,33.3,6,2,1,1,11,23,5,1,5,6,45.5,"MF"
"Filippo Falco","2020-2021",43,14,10,71.4,4,28.6,4,3,0,3,1,1,6,16.7,5,0,0,0,0,4,0,0,5,10,33.3,"FW"
"Panagiotis Tachtsidis","2020-2021",27,33,21,63.6,12,36.4,55,28,26,27,2,22,43,51.2,21,24,6,18,42,97,24,1,58,29,66.7,"MF"
"Fran Karačić","2020-2021",64,14,7,50,7,50,18,8,13,4,1,5,11,45.5,6,13,2,11,21,39,37,0,21,16,56.8,"DF"
"Nicola Rigoni","2020-2021",7,4,1,25,3,75,11,7,7,3,1,3,8,37.5,5,3,1,2,3,14,8,0,7,5,58.3,"MF"
"Gianvito Misuraca","2020-2021",39,14,5,35.7,9,64.3,49,35,17,23,9,12,27,44.4,15,26,8,18,43,92,30,0,26,15,63.4,"MF"
"Adam Chrzanowski","2020-2021",23,6,3,50,3,50,15,14,10,4,1,6,12,50,6,9,4,5,10,25,38,1,14,8,63.6,"DF"
"Davide Adorni","2020-2021",1,1,1,100,0,0,53,34,33,20,0,22,39,56.4,17,43,23,20,59,112,116,2,106,79,57.3,"DF"
"Markus Pavic","2020-2021",29,7,3,42.9,4,57.1,16,13,10,5,1,12,18,66.7,6,15,4,11,19,35,31,0,11,16,40.7,"DF"
"Gianluigi Sueva","2020-2021",43,3,2,66.7,1,33.3,6,3,3,1,2,0,1,0,1,1,0,1,0,6,0,0,4,7,36.4,"FW,DF"
"Luca Paganini","2020-2021",67,8,3,37.5,5,62.5,10,7,5,3,2,7,19,36.8,12,23,5,18,16,26,17,0,20,14,58.8,"MF,DF"
"Giuseppe Zampano","2020-2021",39,10,6,60,4,40,16,12,8,6,2,3,5,60,2,6,3,3,6,22,10,1,1,7,12.5,"DF"
"Nicola Bellomo","2020-2021",125,47,30,63.8,17,36.2,23,13,7,12,4,10,24,41.7,14,9,1,8,7,30,6,0,11,19,36.7,"FW,MF"
"Simone Mazzocchi","2020-2021",130,17,4,23.5,13,76.5,8,6,3,4,1,4,6,66.7,2,10,5,5,3,11,12,0,18,75,19.4,"FW"
"Niko Kirwan","2020-2021",97,27,20,74.1,7,25.9,19,12,11,7,1,11,34,32.4,23,24,2,22,16,35,32,0,20,13,60.6,"DF"
"Alberto Gerbo","2020-2021",45,23,10,43.5,13,56.5,36,22,17,14,5,20,43,46.5,23,29,4,25,19,55,24,0,10,8,55.6,"DF"
"Matteo Rossetti","2020-2021",35,5,2,40,3,60,24,13,13,9,2,2,11,18.2,9,13,2,11,9,33,12,0,22,17,56.4,"MF"
"Antonino Ragusa","2020-2021",108,23,10,43.5,13,56.5,9,8,3,4,2,3,10,30,7,5,1,4,3,12,6,0,11,15,42.3,"FW,MF"
"Matteo Scozzarella","2020-2021",7,11,7,63.6,4,36.4,13,8,7,5,1,6,13,46.2,7,11,1,10,19,32,10,0,1,6,14.3,"MF"
"Damir Ceter","2020-2021",102,45,32,71.1,13,28.9,3,0,0,2,1,2,8,25,6,8,1,7,6,9,13,0,59,76,43.7,"FW"
"Adriano Montalto","2020-2021",42,7,5,71.4,2,28.6,5,2,2,2,1,2,4,50,2,11,3,8,1,6,12,0,33,53,38.4,"FW"
"Luca Vido","2020-2021",110,63,33,52.4,30,47.6,27,20,7,12,8,8,22,36.4,14,33,2,31,7,34,5,0,14,36,28,"MF,FW"
"Pasquale Mazzocchi","2020-2021",117,88,43,48.9,45,51.1,54,31,27,17,10,18,42,42.9,24,27,6,21,38,92,67,0,36,34,51.4,"DF"
"Emanuele Valeri","2020-2021",142,63,28,44.4,35,55.6,51,33,25,19,7,28,55,50.9,27,33,9,24,43,94,44,0,17,22,43.6,"DF"
"Edoardo Masciangelo","2020-2021",141,30,12,40,18,60,34,28,21,11,2,25,38,65.8,13,21,7,14,19,53,53,0,4,16,20,"DF"
"Luca Tremolada","2020-2021",69,18,9,50,9,50,11,4,4,6,1,2,14,14.3,12,11,1,10,8,19,1,0,1,3,25,"MF"
"Giuseppe Loiacono","2020-2021",5,5,3,60,2,40,31,17,13,15,3,18,31,58.1,13,23,15,8,42,73,75,0,53,43,55.2,"DF"
"Dany Mota","2020-2021",274,148,91,61.5,57,38.5,24,15,10,12,2,16,29,55.2,13,20,1,19,10,34,19,0,40,39,50.6,"FW"
"Maxime Leverbe","2020-2021",1,7,7,100,0,0,34,18,22,9,3,18,34,52.9,16,31,20,11,35,69,117,0,68,50,57.6,"DF"
"Christian Dalle Mura","2020-2021",0,1,1,100,0,0,5,3,4,1,0,2,6,33.3,4,7,4,3,16,21,19,0,8,6,57.1,"DF"
"Cristian Buonaiuto","2020-2021",171,66,29,43.9,37,56.1,11,6,4,2,5,4,17,23.5,13,14,0,14,6,17,9,0,5,20,20,"FW,MF"
"Nedim Bajrami","2020-2021",233,114,49,43,65,57,13,6,2,5,6,1,7,14.3,6,10,0,10,9,22,3,0,4,16,20,"MF"
"Francesco Renzetti","2020-2021",132,36,18,50,18,50,51,29,39,10,2,30,44,68.2,14,32,4,28,16,67,50,0,15,23,39.5,"DF"
"Dario Šarić","2020-2021",106,71,36,50.7,35,49.3,68,47,38,26,4,23,56,41.1,33,56,12,44,25,93,40,0,27,44,38,"MF"
"Kevin-Prince Boateng","2020-2021",155,17,8,47.1,9,52.9,14,8,2,8,4,3,17,17.6,14,10,1,9,13,27,12,0,40,33,54.8,"FW,MF"
"Lorenzo Crisetig","2020-2021",29,25,14,56,11,44,62,27,25,33,4,22,52,42.3,30,31,7,24,40,102,52,0,51,50,50.5,"MF"
"Marco Olivieri","2020-2021",78,18,8,44.4,10,55.6,3,2,0,1,2,0,2,0,2,1,0,1,3,6,6,0,3,16,15.8,"FW"
"Andrea Costa","2020-2021",3,5,5,100,0,0,24,14,18,5,1,10,18,55.6,8,9,5,4,40,64,46,0,19,17,52.8,"DF"
"Federico Bonini","2020-2021",4,1,1,100,0,0,3,1,2,1,0,1,2,50,1,5,3,2,9,12,14,0,10,6,62.5,"DF"
"Arlind Ajeti","2020-2021",5,5,2,40,3,60,36,20,25,11,0,14,22,63.6,8,35,22,13,37,73,68,0,41,25,62.1,"DF"
"Nicolas Haas","2020-2021",170,28,15,53.6,13,46.4,63,37,20,36,7,24,61,39.3,37,43,6,37,38,101,26,0,27,39,40.9,"MF"
"Salvatore Bocchetti","2020-2021",0,2,1,50,1,50,17,14,12,5,0,10,14,71.4,4,15,11,4,40,57,79,0,35,28,55.6,"DF"
"Anthony Taugourdeau","2020-2021",19,10,5,50,5,50,35,22,23,8,4,17,39,43.6,22,17,5,12,37,72,37,0,18,30,37.5,"MF"
"Alessandro Crescenzi","2020-2021",19,14,6,42.9,8,57.1,8,5,6,1,1,2,4,50,2,1,0,1,6,14,4,0,2,3,40,"DF"
"Filippo Berra","2020-2021",71,19,12,63.2,7,36.8,40,25,25,13,2,20,31,64.5,11,21,9,12,38,78,57,1,38,31,55.1,"DF"
"Simone Guerra","2020-2021",54,8,5,62.5,3,37.5,15,9,6,8,1,4,14,28.6,10,13,2,11,4,19,6,0,7,21,25,"MF,FW"
"Alessandro Murgia","2020-2021",24,5,3,60,2,40,14,7,7,6,1,7,14,50,7,8,2,6,12,26,13,0,8,11,42.1,"MF"
"Marco Chiosa","2020-2021",2,3,2,66.7,1,33.3,31,19,26,4,1,9,16,56.3,7,37,23,14,47,78,143,0,94,42,69.1,"DF"
"Marco Modolo","2020-2021",3,4,4,100,0,0,19,12,14,4,1,13,18,72.2,5,18,15,3,25,44,121,0,100,42,70.4,"DF"
"Andrea Cistana","2020-2021",0,3,2,66.7,1,33.3,20,13,13,7,0,5,9,55.6,4,14,8,6,39,59,46,1,32,27,54.2,"DF"
"Gian Filippo Felicioli","2020-2021",61,38,18,47.4,20,52.6,18,12,13,3,2,12,19,63.2,7,14,3,11,18,36,31,0,9,14,39.1,"DF"
"Cedric Gondo","2020-2021",89,20,12,60,8,40,6,5,0,3,3,2,8,25,6,6,1,5,10,16,8,0,60,73,45.1,"FW"
"Gennaro Acampora","2019-2020",23,26,20,76.9,6,23.1,14,12,6,8,0,8,15,53.3,7,7,1,6,10,24,5,0,10,7,58.8,"MF"
"Andrea Gasbarro","2019-2020",26,20,12,60,8,40,26,19,13,12,1,10,16,62.5,6,22,6,16,14,40,44,0,21,12,63.6,"DF"
"Michel Morganella","2019-2020",28,8,3,37.5,5,62.5,13,12,8,4,1,9,14,64.3,5,4,2,2,9,22,18,1,19,5,79.2,"DF,MF"
"Luca Ravanelli","2019-2020",8,3,2,66.7,1,33.3,44,27,30,13,1,19,29,65.5,10,43,28,15,44,88,120,0,82,56,59.4,"DF"
"Raffaele Maiello","2019-2020",27,44,29,65.9,15,34.1,50,36,29,16,5,24,54,44.4,30,35,9,26,43,93,38,0,18,22,45,"MF"
"Michele Camporese","2019-2020",4,3,3,100,0,0,19,14,12,5,2,11,14,78.6,3,31,25,6,39,58,110,1,56,35,61.5,"DF"
"Gennaro Borrelli","2019-2020",47,7,2,28.6,5,71.4,8,4,2,5,1,1,4,25,3,5,2,3,0,8,10,0,17,35,32.7,"FW"
"Romano Perticone","2019-2020",4,8,7,87.5,1,12.5,24,15,17,6,1,6,11,54.5,5,11,6,5,21,45,94,0,62,28,68.9,"DF"
"Lorenzo Del Pinto","2019-2020",16,4,1,25,3,75,17,12,6,10,1,4,11,36.4,7,3,1,2,10,27,10,0,4,7,36.4,"MF"
"Mattia Aramu","2019-2020",190,39,17,43.6,22,56.4,17,13,7,6,4,8,24,33.3,16,13,2,11,11,28,7,0,7,31,18.4,"MF"
"Pietro Iemmello","2019-2020",152,41,19,46.3,21,51.2,11,9,2,5,4,1,12,8.3,11,5,0,5,5,16,19,0,38,61,38.4,"FW"
"Davide Mazzocco","2019-2020",63,20,12,60,8,40,38,21,15,20,3,14,33,42.4,19,19,7,12,13,51,24,0,44,32,57.9,"MF"
"Danilo Soddimo","2019-2020",128,45,30,66.7,15,33.3,19,12,6,6,7,6,15,40,9,10,1,9,8,27,4,0,22,42,34.4,"MF,FW"
"Simone Romagnoli","2019-2020",5,5,3,60,2,40,39,32,27,9,3,17,23,73.9,6,39,34,5,27,66,114,1,87,50,63.5,"DF"
"Michele Pellizzer","2019-2020",3,1,1,100,0,0,16,12,13,3,0,8,20,40,12,28,20,8,30,46,122,1,66,43,60.6,"DF"
"Andrey Galabinov","2019-2020",42,12,9,75,3,25,0,0,0,0,0,0,0,NA,0,3,2,1,3,3,14,0,44,23,65.7,"FW"
"Alessandro De Vitis","2019-2020",16,16,11,68.8,5,31.3,40,25,15,23,2,12,32,37.5,20,32,16,16,52,92,94,0,72,47,60.5,"MF,DF"
"Fabrizio Poli","2019-2020",5,7,5,71.4,2,28.6,12,8,9,3,0,7,14,50,7,13,13,0,25,37,64,0,34,27,55.7,"DF"
"Norbert Gyömbér","2019-2020",1,6,5,83.3,1,16.7,36,29,29,5,2,20,31,64.5,11,29,19,10,29,65,139,0,58,24,70.7,"DF"
"Marco Sala","2019-2020",114,60,37,61.7,23,38.3,64,35,42,17,5,30,59,50.8,29,39,11,28,44,108,77,0,15,25,37.5,"DF"
"Leandro Greco","2019-2020",12,12,10,83.3,2,16.7,13,8,2,8,3,4,9,44.4,5,3,0,3,8,21,6,0,5,2,71.4,"MF"
"Nikola Jakimovski","2019-2020",28,3,1,33.3,2,66.7,9,8,6,2,1,6,7,85.7,1,10,1,9,8,17,11,0,14,14,50,"DF,FW"
"Francisco Sierralta","2019-2020",3,3,3,100,0,0,14,12,12,2,0,8,15,53.3,7,10,7,3,11,25,57,0,28,18,60.9,"DF"
"Alessio Vita","2019-2020",99,25,10,40,15,60,43,27,14,22,7,19,57,33.3,38,33,2,31,20,63,15,1,18,39,31.6,"MF"
"Moutir Chajia","2019-2020",73,33,22,66.7,11,33.3,5,3,1,1,3,2,7,28.6,5,9,0,9,0,5,0,0,2,14,12.5,"MF,FW"
"Martin Erlic","2019-2020",2,1,1,100,0,0,18,14,13,4,1,7,9,77.8,2,21,12,9,31,49,72,0,39,40,49.4,"DF"
"Michele Troiano","2019-2020",6,2,1,50,1,50,31,19,19,11,1,17,38,44.7,21,15,4,11,19,50,31,0,20,8,71.4,"MF"
"Alessio Tribuzzi","2019-2020",17,16,8,50,8,50,5,5,2,3,0,3,10,30,7,6,0,6,8,13,2,0,3,7,30,"MF"
"Samuele Longo","2019-2020",94,37,18,48.6,19,51.4,13,10,2,6,5,5,20,25,15,16,4,12,3,16,16,0,22,45,32.8,"FW"
"Lorenzo Lollo","2019-2020",27,24,13,54.2,11,45.8,57,32,29,25,3,29,57,50.9,28,36,6,30,17,74,15,0,20,12,62.5,"MF"
"Lorenzo Dickmann","2019-2020",114,53,28,52.8,25,47.2,81,50,49,28,4,31,71,43.7,40,15,4,11,45,126,56,0,10,17,37,"DF"
"Tomasz Kupisz","2019-2020",100,16,5,31.3,11,68.8,40,25,15,12,13,17,29,58.6,12,30,6,24,13,53,27,0,32,27,54.2,"DF,FW"
"Roberto Zammarini","2019-2020",21,8,5,62.5,3,37.5,19,12,12,7,0,12,22,54.5,10,16,4,12,9,28,18,0,12,14,46.2,"MF"
"Elio Capradossi","2019-2020",2,6,5,83.3,1,16.7,40,27,25,15,0,12,19,63.2,7,30,19,11,61,101,137,1,95,62,60.5,"DF"
"Riccardo Idda","2019-2020",4,4,3,75,1,25,35,20,20,15,0,15,35,42.9,20,38,28,10,38,73,161,1,78,41,65.5,"DF"
"Simone Benedetti","2019-2020",3,13,11,84.6,2,15.4,63,36,39,24,0,26,37,70.3,11,31,18,13,58,121,136,0,69,57,54.8,"DF"
"Davide Petrucci","2019-2020",11,23,18,78.3,5,21.7,52,37,30,22,0,23,48,47.9,25,16,4,12,33,85,25,0,23,22,51.1,"MF"
"Francesco Migliore","2019-2020",131,28,14,50,14,50,22,20,8,8,6,10,23,43.5,13,13,2,11,28,50,54,0,40,27,59.7,"DF"
"Michele Marconi","2019-2020",111,10,6,60,4,40,5,4,2,3,0,2,6,33.3,4,8,3,5,6,11,20,0,168,100,62.7,"FW"
"Jure Balkovec","2019-2020",112,21,15,71.4,6,28.6,44,28,26,14,4,26,43,60.5,17,30,13,17,29,73,71,1,28,38,42.4,"DF"
"Amato Ciciretti","2019-2020",107,24,12,50,12,50,11,5,8,2,1,6,22,27.3,16,9,0,9,12,23,2,0,6,10,37.5,"FW"
"Simone Bastoni","2019-2020",35,12,7,58.3,5,41.7,30,24,15,11,4,11,16,68.8,5,3,0,3,7,37,14,0,15,12,55.6,"DF"
"Marco Sau","2019-2020",164,40,21,52.5,19,47.5,15,10,4,7,4,4,19,21.1,15,16,0,16,7,22,1,0,10,12,45.5,"FW,MF"
"Jérémie Broh","2019-2020",19,3,1,33.3,2,66.7,9,6,2,6,1,4,9,44.4,5,9,5,4,7,16,6,0,9,5,64.3,"MF"
"Aleandro Rosi","2019-2020",68,14,7,50,7,50,40,27,24,14,2,20,32,62.5,12,21,8,13,36,76,81,0,61,39,61,"DF"
"Roberto Pirrello","2019-2020",9,7,4,57.1,3,42.9,33,17,17,12,4,18,34,52.9,16,12,7,5,14,47,43,0,21,17,55.3,"DF"
"Oliver Kragl","2019-2020",85,34,20,58.8,14,41.2,19,9,8,6,5,9,23,39.1,14,18,1,17,11,30,13,0,8,11,42.1,"MF,FW"
"Emanuele Giaccherini","2019-2020",148,37,22,59.5,15,40.5,15,8,6,7,2,9,26,34.6,17,10,3,7,10,25,5,0,11,13,45.8,"MF,FW"
"Antonio Piccolo","2019-2020",86,31,23,74.2,8,25.8,5,4,1,2,2,0,6,0,6,2,0,2,2,7,4,1,2,7,22.2,"MF,FW"
"Cristian Molinaro","2019-2020",34,8,4,50,4,50,8,4,6,2,0,3,3,100,0,6,3,3,10,18,29,0,6,5,54.5,"DF"
"Andrea Settembrini","2019-2020",56,35,20,57.1,15,42.9,29,16,12,10,7,14,44,31.8,30,25,4,21,22,51,26,0,13,33,28.3,"MF,DF"
"Filippo Sgarbi","2019-2020",9,11,9,81.8,2,18.2,31,21,20,11,0,10,23,43.5,13,28,16,12,14,45,73,0,33,22,60,"DF"
"Luca Garritano","2019-2020",120,31,13,41.9,18,58.1,37,27,15,18,4,17,39,43.6,22,35,5,30,22,59,23,0,13,24,35.1,"MF"
"Vladimir Golemić","2019-2020",21,8,6,75,2,25,27,14,19,7,1,14,22,63.6,8,23,15,8,68,95,86,0,96,49,66.2,"DF"
"Samuele Birindelli","2019-2020",57,24,11,45.8,13,54.2,46,35,26,15,5,20,30,66.7,10,27,9,18,33,79,58,0,16,16,50,"DF"
"Walter López","2019-2020",82,9,5,55.6,4,44.4,17,10,12,4,1,8,18,44.4,10,11,3,8,16,33,37,0,21,10,67.7,"DF,FW"
"Camillo Ciano","2019-2020",200,41,20,48.8,21,51.2,21,13,4,13,4,6,27,22.2,21,22,2,20,7,28,5,0,14,55,20.3,"FW,MF"
"Alessandro Salvi","2019-2020",81,19,12,63.2,7,36.8,27,18,14,10,3,9,19,47.4,10,23,6,17,23,50,28,1,62,28,68.9,"DF,FW"
"Luca Caldirola","2019-2020",3,1,0,0,1,100,29,21,20,8,1,8,23,34.8,15,24,16,8,49,78,128,0,72,37,66.1,"DF"
"Fabrizio Caligara","2019-2020",30,15,11,73.3,4,26.7,31,21,16,9,6,13,27,48.1,14,22,2,20,15,46,22,0,6,13,31.6,"MF"
"Sauli Väisänen","2019-2020",4,2,1,50,1,50,16,11,9,6,1,7,13,53.8,6,21,13,8,21,37,73,1,48,26,64.9,"DF"
"Matteo Mancosu","2019-2020",73,11,7,63.6,4,36.4,15,8,4,9,2,5,17,29.4,12,7,0,7,5,20,11,0,30,53,36.1,"FW"
"Massimo Volta","2019-2020",1,3,3,100,0,0,11,9,8,3,0,5,8,62.5,3,11,7,4,13,24,64,0,36,19,65.5,"DF"
"Stefano Pettinari","2019-2020",313,100,48,48,52,52,34,21,5,16,13,8,26,30.8,18,25,2,23,5,39,40,0,57,92,38.3,"FW"
"Gaetano Monachello","2019-2020",73,11,5,45.5,6,54.5,10,6,1,3,6,1,7,14.3,6,3,0,3,3,13,6,0,16,36,30.8,"FW"
"Luca Verna","2019-2020",37,16,15,93.8,1,6.3,7,5,3,2,2,4,8,50,4,10,2,8,11,18,12,0,7,10,41.2,"MF,DF"
"Alessandro Tuia","2019-2020",0,6,6,100,0,0,21,16,16,5,0,3,15,20,12,13,8,5,28,49,73,0,38,11,77.6,"DF"
"Giuseppe Mastinu","2019-2020",65,19,9,47.4,10,52.6,29,20,10,15,4,13,27,48.1,14,16,1,15,3,32,7,0,3,9,25,"MF,FW"
"Vlad Dragomir","2019-2020",52,16,12,75,4,25,32,17,10,14,8,10,24,41.7,14,27,4,23,15,47,24,0,9,25,26.5,"MF"
"Alfredo Bifulco","2019-2020",81,46,19,41.3,27,58.7,16,6,5,3,8,2,14,14.3,12,10,1,9,6,22,4,0,17,16,51.5,"MF,FW"
"Marco Rosafio","2019-2020",93,21,10,47.6,11,52.4,8,5,2,4,2,1,3,33.3,2,10,0,10,1,9,5,0,16,28,36.4,"FW"
"Davide Frattesi","2019-2020",184,68,36,52.9,32,47.1,45,23,19,23,3,14,36,38.9,22,30,4,26,21,66,32,0,16,26,38.1,"MF"
"Grigoris Kastanos","2019-2020",28,29,19,65.5,10,34.5,50,35,14,34,2,23,36,63.9,13,22,10,12,24,74,23,0,23,25,47.9,"MF"
"Hugo Campagnaro","2019-2020",1,1,0,0,1,100,14,5,11,3,0,6,10,60,4,11,9,2,21,35,35,0,8,12,40,"DF"
"Luca Valzania","2019-2020",99,57,27,47.4,30,52.6,56,32,20,30,6,23,58,39.7,35,32,6,26,26,82,30,0,29,32,47.5,"MF"
"Luka Krajnc","2019-2020",1,2,2,100,0,0,11,6,7,3,1,5,5,100,0,13,8,5,16,27,41,0,34,16,68,"DF"
"Luca Strizzolo","2019-2020",145,12,7,58.3,5,41.7,14,8,3,10,1,2,10,20,8,18,2,16,13,27,21,0,103,112,47.9,"FW"
"Luca Bittante","2019-2020",43,19,8,42.1,11,57.9,18,13,14,3,1,11,23,47.8,12,18,2,16,20,38,34,0,20,21,48.8,"DF,MF"
"Mirko Bruccini","2019-2020",67,20,9,45,11,55,55,36,23,30,2,19,67,28.4,48,51,10,41,61,116,48,0,23,36,39,"MF"
"Daniel Semenzato","2019-2020",36,10,4,40,6,60,14,7,7,5,2,4,18,22.2,14,13,6,7,19,33,34,0,4,7,36.4,"DF"
"Riccardo Meggiorini","2019-2020",159,25,13,52,12,48,14,10,2,7,5,3,14,21.4,11,19,4,15,7,21,12,0,113,91,55.4,"FW"
"Michael De Marchi","2019-2020",46,25,12,48,13,52,2,1,1,1,0,1,6,16.7,5,5,0,5,0,2,3,0,24,33,42.1,"FW,MF"
"Davide Bettella","2019-2020",12,32,19,59.4,13,40.6,39,25,23,14,2,19,32,59.4,13,31,17,14,62,101,85,2,34,41,45.3,"DF"
"Marcel Büchel","2019-2020",9,9,5,55.6,4,44.4,3,3,1,2,0,1,3,33.3,2,7,0,7,14,17,2,0,11,4,73.3,"MF"
"Gaetano Masucci","2019-2020",145,20,8,40,12,60,22,20,8,11,3,8,27,29.6,19,18,1,17,9,31,18,0,70,109,39.1,"FW"
"Davide Moscardelli","2019-2020",37,16,4,25,12,75,4,2,1,1,2,2,6,33.3,4,2,2,0,1,5,4,0,15,16,48.4,"FW"
"Raffaele Pucino","2019-2020",27,9,8,88.9,1,11.1,22,12,13,6,3,14,21,66.7,7,15,12,3,19,41,56,0,19,15,55.9,"DF"
"Leonardo Mancuso","2019-2020",186,25,9,36,16,64,8,4,0,4,4,3,13,23.1,10,14,4,10,7,15,12,0,40,53,43,"FW"
"Zinédine Machach","2019-2020",62,60,42,70,17,28.3,14,13,2,7,5,2,11,18.2,9,9,1,8,1,15,3,0,11,29,27.5,"FW,MF"
"Luca Clemenza","2019-2020",60,30,17,56.7,13,43.3,10,5,2,7,1,3,13,23.1,10,4,2,2,8,18,1,0,1,7,12.5,"MF,FW"
"Christian Maggio","2019-2020",133,34,18,52.9,16,47.1,82,53,47,28,7,51,97,52.6,46,36,11,25,37,119,77,1,55,37,59.8,"DF"
"Riccardo Brosco","2019-2020",3,6,6,100,0,0,30,18,23,7,0,15,23,65.2,8,31,21,10,37,67,162,1,153,64,70.5,"DF"
"Davide Brivio","2019-2020",32,8,5,62.5,3,37.5,11,10,4,6,1,5,10,50,5,4,1,3,6,17,16,0,14,4,77.8,"DF"
"Andrea Barberis","2019-2020",51,37,27,73,10,27,54,39,19,33,2,15,64,23.4,49,37,7,30,49,103,25,0,40,16,71.4,"MF"
"Marco Migliorini","2019-2020",3,5,3,60,2,40,32,24,23,9,0,18,24,75,6,29,17,12,42,74,111,2,37,28,56.9,"DF"
"Francesco Di Mariano","2019-2020",149,19,8,42.1,11,57.9,14,7,2,11,1,4,9,44.4,5,5,1,4,4,18,4,0,4,20,16.7,"FW,MF"
"Juan Manuel Ramos","2019-2020",36,10,8,80,2,20,13,10,9,3,1,8,11,72.7,3,15,5,10,6,19,34,0,12,15,44.4,"DF"
"Stefano Scognamillo","2019-2020",3,3,2,66.7,1,33.3,43,23,30,10,3,14,24,58.3,10,36,19,17,46,89,95,1,47,28,62.7,"DF"
"Cristian Andreoni","2019-2020",99,16,7,43.8,9,56.3,20,12,13,6,1,6,18,33.3,12,18,4,14,20,40,34,0,24,20,54.5,"DF"
"Mattia Minesso","2019-2020",46,17,11,64.7,6,35.3,13,6,4,6,3,2,6,33.3,4,11,1,10,7,20,7,0,12,23,34.3,"MF,FW"
"Luca Palmiero","2019-2020",11,19,13,68.4,6,31.6,40,24,15,23,2,15,52,28.8,37,25,3,22,26,66,22,1,11,16,40.7,"MF"
"Gianluca Gaetano","2019-2020",64,15,10,66.7,5,33.3,9,6,5,3,1,3,12,25,9,12,1,11,8,17,7,0,5,17,22.7,"MF,FW"
"Luca Pagliarulo","2019-2020",1,1,1,100,0,0,21,11,11,9,1,7,18,38.9,11,24,18,6,25,46,96,0,45,29,60.8,"DF"
"Carlo Crialese","2019-2020",19,4,1,25,3,75,26,16,20,6,0,11,20,55,9,10,1,9,13,39,27,0,8,14,36.4,"DF,FW"
"Jacopo Segre","2019-2020",127,44,22,50,22,50,55,35,24,23,8,24,56,42.9,32,54,8,46,28,83,23,0,42,35,54.5,"MF"
"Matteo Ricci","2019-2020",18,24,14,58.3,10,41.7,53,34,19,25,9,14,35,40,21,17,3,14,20,73,24,0,14,8,63.6,"MF"
"Cristian Cauz","2019-2020",23,4,1,25,3,75,5,3,3,2,0,2,6,33.3,4,7,2,5,3,8,9,0,7,6,53.8,"DF"
"Domenico Maietta","2019-2020",2,12,8,66.7,4,33.3,40,28,25,14,1,16,33,48.5,17,32,21,11,34,74,97,1,58,37,61.1,"DF"
"Gaetano Letizia","2019-2020",105,42,27,64.3,15,35.7,71,52,46,23,2,38,64,59.4,26,30,11,19,44,115,66,1,24,24,50,"DF"
"Nicolò Casale","2019-2020",2,1,1,100,0,0,24,16,23,1,0,16,17,94.1,1,17,10,7,16,40,46,0,39,30,56.5,"DF"
"Luca Ghiringhelli","2019-2020",56,7,5,71.4,2,28.6,40,22,19,16,5,20,28,71.4,8,28,6,22,28,68,62,0,33,26,55.9,"DF"
"Marcos Curado","2019-2020",3,4,1,25,3,75,11,8,9,1,1,4,8,50,4,10,5,5,9,20,19,0,14,15,48.3,"DF"
"Milan Đurić","2019-2020",119,24,13,54.2,11,45.8,8,5,2,4,2,0,6,0,6,14,2,12,1,9,20,0,119,58,67.2,"FW"
"Lucas Chiaretti","2019-2020",43,21,11,52.4,10,47.6,8,5,2,4,2,2,9,22.2,7,8,0,8,6,14,4,0,5,17,22.7,"MF"
"Luca Antonelli","2019-2020",32,11,6,54.5,5,45.5,9,4,4,3,2,3,5,60,2,9,2,7,15,24,15,0,14,10,58.3,"DF"
"Matija Boben","2019-2020",2,7,6,85.7,1,14.3,73,46,46,21,6,20,33,60.6,13,36,19,17,64,137,96,0,67,57,54,"DF"
"Luca Mora","2019-2020",72,25,4,16,21,84,28,14,10,10,8,16,34,47.1,18,18,4,14,17,45,33,0,32,27,54.2,"MF"
"Antonio Mazzotta","2019-2020",169,24,10,41.7,14,58.3,24,18,10,10,4,12,28,42.9,16,12,3,9,21,45,17,0,13,29,31,"DF"
"Andrea Beghetto","2019-2020",165,16,4,25,12,75,31,17,11,10,10,15,29,51.7,14,11,3,8,11,42,35,0,4,14,22.2,"DF,FW"
"Federico Proia","2019-2020",54,23,14,60.9,9,39.1,38,21,15,19,4,15,35,42.9,20,20,0,20,7,45,16,2,26,24,52,"MF"
"Antonio Vacca","2019-2020",25,18,15,83.3,3,16.7,26,12,11,13,2,12,26,46.2,14,11,2,9,13,39,7,0,10,13,43.5,"MF"
"Nicolas Viola","2019-2020",97,47,30,63.8,16,34,40,26,14,17,9,15,38,39.5,23,19,5,14,27,67,23,0,9,19,32.1,"MF"
"Petar Brlek","2019-2020",62,35,25,71.4,10,28.6,28,21,13,12,3,12,37,32.4,25,19,3,16,27,55,12,0,10,21,32.3,"MF"
"Nicola Pavan","2019-2020",4,5,4,80,1,20,18,11,11,7,0,10,23,43.5,13,10,5,5,12,30,30,0,46,33,58.2,"MF,DF"
"Antreas Karo","2019-2020",9,9,7,77.8,2,22.2,24,15,17,6,1,12,13,92.3,1,25,19,6,28,52,55,2,29,18,61.7,"DF"
"Ivan Lakićević","2019-2020",68,12,8,66.7,4,33.3,21,12,11,4,6,14,20,70,6,15,5,10,13,34,49,0,6,14,30,"DF"
"Mauro Coppolaro","2019-2020",32,11,9,81.8,2,18.2,33,22,21,8,4,21,34,61.8,13,25,7,18,21,54,85,0,46,17,73,"DF"
"Filip Piszczek","2019-2020",34,6,2,33.3,4,66.7,6,5,3,1,2,2,9,22.2,7,6,0,6,1,7,6,0,14,35,28.6,"FW"
"Andrew Gravillon","2019-2020",8,9,7,77.8,2,22.2,43,31,33,8,2,24,34,70.6,10,48,41,7,35,78,132,0,54,33,62.1,"DF"
"Salvatore Aloi","2019-2020",34,13,8,61.5,5,38.5,17,8,8,8,1,6,15,40,9,11,2,9,8,25,7,0,3,6,33.3,"MF"
"Gregorio Luperini","2019-2020",52,30,15,50,15,50,45,27,27,12,6,17,47,36.2,30,36,7,29,19,64,21,0,64,62,50.8,"MF"
"Alessandro Buongiorno","2019-2020",6,7,4,57.1,3,42.9,17,13,13,3,1,7,10,70,3,9,5,4,12,29,44,0,35,20,63.6,"DF"
"Mirko Carretta","2019-2020",179,59,33,55.9,26,44.1,5,2,0,4,1,0,14,0,14,12,1,11,10,15,3,0,14,33,29.8,"FW"
"Emanuele Cicerelli","2019-2020",85,83,49,59,34,41,36,29,25,10,1,20,44,45.5,24,17,3,14,27,63,14,1,12,9,57.1,"DF,FW"
"Enrico Del Prato","2019-2020",117,22,15,68.2,7,31.8,41,31,24,12,5,19,31,61.3,12,32,9,23,29,70,56,0,29,42,40.8,"DF,MF"
"Massimo Coda","2019-2020",166,35,19,54.3,16,45.7,5,3,1,2,2,2,25,8,23,14,3,11,6,11,13,0,99,102,49.3,"FW"
"Fabio Ceravolo","2019-2020",103,21,10,47.6,11,52.4,4,1,2,1,1,0,5,0,5,5,1,4,4,8,10,0,27,57,32.1,"FW"
"Pietro Ceccaroni","2019-2020",62,28,20,71.4,8,28.6,40,28,22,15,3,14,22,63.6,8,38,20,18,38,78,99,0,31,45,40.8,"DF"
"Magnus Troest","2019-2020",3,2,2,100,0,0,29,20,24,5,0,12,30,40,18,28,18,10,35,64,136,0,76,43,63.9,"DF"
"Davide Luppi","2019-2020",149,35,21,60,14,40,20,11,3,8,9,4,17,23.5,13,21,0,21,13,33,7,0,27,42,39.1,"FW,MF"
"Angelo Corsi","2019-2020",45,20,13,65,7,35,31,23,13,11,7,10,21,47.6,11,18,7,11,10,41,43,0,13,14,48.1,"DF,MF"
"Mario Gargiulo","2019-2020",50,7,4,57.1,3,42.9,9,4,3,5,1,4,12,33.3,8,11,1,10,5,14,7,1,16,7,69.6,"MF"
"Riccardo Bocalon","2019-2020",152,25,14,56,11,44,4,3,1,2,1,1,11,9.1,10,8,1,7,7,11,30,0,67,84,44.4,"FW,MF"
"Agostino Camigliano","2019-2020",0,1,0,0,1,100,6,3,3,3,0,3,4,75,1,11,7,4,6,12,43,0,25,16,61,"DF"
"Federico Ricci","2019-2020",176,60,32,53.3,28,46.7,35,24,14,14,7,15,29,51.7,14,13,0,13,7,42,2,0,7,26,21.2,"FW"
"Salvatore Molina","2019-2020",256,80,52,65,28,35,44,25,21,17,6,13,35,37.1,22,39,6,33,24,68,42,0,33,21,61.1,"DF"
"Nicolò Brighenti","2019-2020",17,4,2,50,2,50,50,28,39,10,1,19,39,48.7,20,45,26,19,60,110,108,0,65,38,63.1,"DF"
"Claudio Terzi","2019-2020",1,3,3,100,0,0,23,15,16,7,0,12,20,60,8,15,8,7,33,56,64,2,62,45,57.9,"DF"
"Tommaso Pobega","2019-2020",86,38,25,65.8,13,34.2,66,40,29,30,7,19,59,32.2,40,60,14,46,46,112,53,0,69,63,52.3,"MF"
"Fabio Maistro","2019-2020",75,68,46,67.6,22,32.4,31,23,20,8,3,16,39,41,23,25,5,20,16,47,18,0,16,17,48.5,"MF"
"Sven Braken","2019-2020",96,26,10,38.5,16,61.5,8,5,1,6,1,1,9,11.1,8,8,2,6,2,10,14,0,82,78,51.3,"FW"
"Nicola Dalmonte","2019-2020",106,25,14,56,11,44,15,6,4,7,4,3,10,30,7,13,0,13,3,18,4,0,6,22,21.4,"FW"
"Vasile Mogos","2019-2020",100,23,12,52.2,11,47.8,20,11,9,8,3,9,21,42.9,12,19,9,10,11,31,34,0,52,47,52.5,"DF,FW"
"Alberto Rizzo","2019-2020",15,13,3,23.1,8,61.5,24,15,16,6,2,13,24,54.2,11,10,1,9,23,47,33,0,15,13,53.6,"DF"
"Patryk Dziczek","2019-2020",18,10,9,90,1,10,34,18,19,11,4,13,41,31.7,28,21,6,15,23,57,35,3,18,12,60,"MF"
"Salvatore D'Elia","2019-2020",91,15,7,46.7,8,53.3,21,12,11,7,3,10,22,45.5,12,10,2,8,16,37,24,1,18,16,52.9,"DF,FW"
"Manuel Marras","2019-2020",241,85,49,57.6,36,42.4,31,18,11,14,6,9,42,21.4,33,26,1,25,18,49,3,0,13,39,25,"FW,MF"
"Massimiliano Busellato","2019-2020",107,18,9,50,9,50,40,28,21,17,2,14,41,34.1,27,26,3,23,31,71,16,0,10,12,45.5,"MF"
"Marco Firenze","2019-2020",62,12,5,41.7,7,58.3,8,5,2,4,2,2,6,33.3,4,7,1,6,3,11,6,0,3,6,33.3,"MF,DF"
"Luca Germoni","2019-2020",50,30,15,50,15,50,40,32,21,15,4,14,29,48.3,15,19,5,14,17,57,35,2,14,13,51.9,"DF"
"Salvatore Esposito","2019-2020",26,15,9,60,6,40,43,28,19,22,2,12,45,26.7,33,21,3,18,16,59,38,0,22,21,51.2,"MF"
"Patrick Ciurria","2019-2020",201,63,28,44.4,35,55.6,16,15,2,9,5,5,12,41.7,7,16,2,14,1,17,8,0,21,43,32.8,"FW,MF"
"Simone Padoin","2019-2020",79,21,13,61.9,8,38.1,38,23,27,9,2,20,37,54.1,17,18,4,14,19,57,54,0,17,22,43.6,"DF,MF"
"Matteo Cotali","2019-2020",34,7,4,57.1,3,42.9,14,10,6,7,1,8,13,61.5,5,8,2,6,10,24,12,0,9,6,60,"DF"
"Andrés Tello","2019-2020",103,30,16,53.3,14,46.7,27,20,16,8,3,11,33,33.3,22,24,4,20,25,52,24,1,30,29,50.8,"MF"
"Paolo Bartolomei","2019-2020",111,34,19,55.9,15,44.1,35,20,14,16,5,17,43,39.5,26,18,4,14,15,50,28,0,21,17,55.3,"MF"
"Claudio Morra","2019-2020",125,33,16,48.5,17,51.5,19,15,6,7,6,3,9,33.3,6,30,2,28,7,26,9,0,23,64,26.4,"FW"
"Manuel De Luca","2019-2020",62,14,7,50,7,50,9,7,3,3,3,0,8,0,8,8,0,8,3,12,14,0,32,50,39,"FW"
"Matteo Pallecchi","2019-2020",32,6,3,50,3,50,5,4,4,0,1,2,5,40,3,3,1,2,2,7,2,0,7,7,50,"FW"
"Joel Obi","2019-2020",37,24,14,58.3,10,41.7,47,28,14,32,1,16,38,42.1,22,25,3,22,44,91,23,1,38,35,52.1,"MF"
"Marco Capuano","2019-2020",3,5,4,80,1,20,29,21,19,10,0,16,24,66.7,8,24,15,9,15,44,100,0,73,37,66.4,"DF"
"Marco Toscano","2019-2020",35,11,5,45.5,6,54.5,17,11,10,7,0,7,17,41.2,10,8,2,6,9,26,10,0,10,19,34.5,"MF"
"Nicolas Frey","2019-2020",21,4,3,75,1,25,9,5,7,2,0,5,12,41.7,7,7,3,4,8,17,20,0,13,11,54.2,"DF"
"Andrea Colpani","2019-2020",112,62,35,56.5,27,43.5,27,19,7,13,7,11,24,45.8,13,24,2,22,33,60,8,0,19,19,50,"MF"
"Giuseppe De Luca","2019-2020",195,32,12,37.5,19,59.4,18,13,10,4,4,4,23,17.4,19,23,3,20,2,20,4,0,32,93,25.6,"FW"
"Filippo Melegoni","2019-2020",31,8,5,62.5,3,37.5,7,5,3,4,0,1,8,12.5,7,8,4,4,6,13,9,0,1,5,16.7,"MF"
"Gabriele Morelli","2019-2020",23,5,2,40,3,60,13,9,9,4,0,9,12,75,3,9,4,5,7,20,29,0,14,13,51.9,"DF"
"Claiton","2019-2020",1,1,1,100,0,0,13,9,10,3,0,9,18,50,9,21,18,3,20,33,50,0,44,18,71,"DF"
"Erick Ferigra","2019-2020",0,4,4,100,0,0,15,11,10,5,0,5,12,41.7,7,17,10,7,17,32,30,0,11,15,42.3,"DF"
"Alessandro Vogliacco","2019-2020",9,1,0,0,1,100,23,11,14,8,1,7,17,41.2,10,20,7,13,23,46,78,0,25,25,50,"DF"
"Gianluca Di Chiara","2019-2020",129,25,13,52,11,44,32,22,19,10,3,11,30,36.7,19,28,9,19,20,52,52,0,8,18,30.8,"DF"
"Lorenzo Ariaudo","2019-2020",4,4,4,100,0,0,20,14,12,8,0,4,10,40,6,20,17,3,23,43,117,1,59,63,48.4,"DF"
"Francesco Stanco","2019-2020",39,6,2,33.3,4,66.7,4,2,1,3,0,2,4,50,2,7,0,7,0,4,11,0,24,23,51.1,"FW"
"Simone Pasa","2019-2020",15,4,1,25,3,75,16,9,5,10,1,6,14,42.9,8,13,5,8,10,26,18,0,10,13,43.5,"MF"
"Raúl Asencio","2019-2020",51,5,3,60,2,40,4,3,2,2,0,2,4,50,2,7,1,6,3,7,8,0,46,49,48.4,"FW"
"Francesco Forte","2019-2020",129,41,15,36.6,26,63.4,19,14,4,12,3,4,13,30.8,9,15,3,12,6,25,25,0,68,109,38.4,"FW"
"Michele De Agostini","2019-2020",97,32,17,53.1,15,46.9,58,35,34,20,4,27,58,46.6,31,40,9,31,54,112,116,2,62,40,60.8,"DF"
"Ramzi Aya","2019-2020",5,2,0,0,2,100,19,11,12,7,0,10,19,52.6,9,34,24,10,38,57,131,0,73,52,58.4,"DF"
"Sveinn Guðjohnsen","2019-2020",45,3,2,66.7,1,33.3,7,2,2,2,3,6,10,60,4,3,0,3,1,8,17,0,29,38,43.3,"FW"
"Jonathan Biabiany","2019-2020",47,26,16,61.5,10,38.5,9,3,0,7,2,1,2,50,1,4,0,4,0,9,2,0,6,21,22.2,"FW"
"Francesco Belli","2019-2020",31,9,8,88.9,1,11.1,17,15,9,6,2,8,11,72.7,3,16,6,10,4,21,37,0,17,16,51.5,"DF"
"Stefan Strandberg","2019-2020",0,2,2,100,0,0,13,8,8,5,0,8,11,72.7,3,13,8,5,18,31,48,1,41,22,65.1,"DF"
"Soufiane Bidaoui","2019-2020",138,51,33,64.7,18,35.3,6,2,2,2,2,0,5,0,5,7,1,6,5,11,3,0,2,18,10,"FW"
"Tommaso D'Orazio","2019-2020",56,28,13,46.4,15,53.6,32,21,15,13,4,16,34,47.1,18,9,4,5,22,54,35,0,23,21,52.3,"DF,MF"
"Salvatore Monaco","2019-2020",2,5,4,80,1,20,6,3,2,4,0,5,10,50,5,15,11,4,17,23,76,0,42,18,70,"DF"
"Lamin Jallow","2019-2020",119,42,20,47.6,22,52.4,8,5,3,5,0,3,10,30,7,12,2,10,2,10,1,0,13,29,31,"FW"
"Marcello Falzerano","2019-2020",150,68,47,69.1,21,30.9,42,20,25,9,8,14,43,32.6,29,37,3,34,29,71,22,0,2,13,13.3,"MF"
"Antonio Porcino","2019-2020",122,18,9,50,9,50,34,18,22,10,2,15,29,51.7,14,27,7,20,22,56,51,1,12,18,40,"DF,MF"
"Nicholas Siega","2019-2020",87,45,22,48.9,23,51.1,51,32,21,24,6,13,37,35.1,24,43,7,36,13,64,13,0,23,29,44.2,"MF"
"Luca Nizzetto","2019-2020",40,6,3,50,3,50,17,9,4,12,1,4,13,30.8,9,8,1,7,11,28,10,0,3,7,30,"MF"
"Niccolò Zanellato","2019-2020",75,8,6,75,2,25,17,10,4,12,1,5,14,35.7,9,5,0,5,6,23,12,0,29,23,55.8,"MF"
"Francesco Deli","2019-2020",40,41,21,51.2,20,48.8,16,11,4,10,2,6,14,42.9,8,10,1,9,3,19,10,0,8,18,30.8,"MF"
"Tiago Casasola","2019-2020",103,22,13,59.1,9,40.9,43,29,30,11,2,32,39,82.1,7,13,3,10,17,60,31,0,7,10,41.2,"DF,MF"
"Franck Kanouté","2019-2020",21,47,37,78.7,10,21.3,35,21,14,18,3,12,26,46.2,14,22,8,14,29,64,8,0,7,8,46.7,"MF"
"Vittorio Parigini","2019-2020",104,32,14,43.8,18,56.3,13,4,4,6,3,4,15,26.7,11,4,0,4,7,20,3,0,5,13,27.8,"FW,MF"
"Alejandro Rodríguez","2019-2020",91,14,7,50,7,50,9,5,2,3,4,3,6,50,3,6,0,6,4,13,13,0,33,33,50,"FW"
"Davide Gavazzi","2019-2020",160,79,43,54.4,36,45.6,27,20,4,20,3,13,39,33.3,26,23,5,18,17,44,22,0,17,29,37,"MF"
"Alessandro Fiordaliso","2019-2020",111,8,4,50,4,50,21,14,11,6,4,10,16,62.5,6,22,10,12,28,49,36,0,31,31,50,"DF"
"Pepín","2019-2020",137,70,46,65.7,24,34.3,47,34,20,17,10,15,37,40.5,22,28,2,26,22,69,10,0,9,20,31,"MF,FW"
"Stefano Moreo","2019-2020",43,4,1,25,3,75,4,3,0,4,0,1,4,25,3,4,1,3,4,8,5,0,33,32,50.8,"FW"
"Nicholas Pierini","2019-2020",77,39,22,56.4,17,43.6,8,5,2,3,3,0,14,0,14,8,0,8,4,12,8,0,16,39,29.1,"FW"
"Mirko Gori","2019-2020",55,13,9,69.2,4,30.8,66,47,33,27,6,27,69,39.1,42,29,7,22,26,92,21,0,12,24,33.3,"MF"
"Nicola Falasco","2019-2020",4,13,10,76.9,3,23.1,15,12,10,5,0,12,16,75,4,17,10,7,11,26,41,1,12,20,37.5,"DF"
"Cristian Galano","2019-2020",264,64,39,60.9,25,39.1,23,16,5,11,7,6,26,23.1,20,6,0,6,6,29,5,0,11,32,25.6,"FW,MF"
"Robert Gucher","2019-2020",91,69,44,63.8,25,36.2,55,33,23,26,6,22,65,33.8,43,53,13,40,34,89,23,0,37,48,43.5,"MF"
"Ledian Memushaj","2019-2020",143,66,33,50,33,50,35,26,15,12,8,11,33,33.3,22,19,2,17,20,55,35,1,27,39,40.9,"MF"
"Simeon Nwankwo","2019-2020",246,53,33,62.3,20,37.7,15,8,2,8,5,3,15,20,12,18,4,14,3,18,35,0,55,57,49.1,"FW"
"Eros Pisano","2019-2020",16,2,0,0,2,100,15,9,10,2,3,3,6,50,3,9,2,7,5,20,17,0,17,6,73.9,"DF"
"Antonino La Gumina","2019-2020",86,24,11,45.8,12,50,6,5,1,2,3,2,6,33.3,4,5,1,4,1,7,6,0,19,25,43.2,"FW"
"Nadir Zortea","2019-2020",62,77,42,54.5,35,45.5,21,13,11,6,4,8,15,53.3,7,16,3,13,18,39,35,1,18,25,41.9,"DF,MF"
"Paolo Fernandes","2019-2020",59,41,24,58.5,17,41.5,6,3,1,3,2,1,2,50,1,9,0,9,2,8,5,0,0,8,0,"MF"
"Žan Celar","2019-2020",72,13,6,46.2,7,53.8,5,3,1,3,1,1,3,33.3,2,2,0,2,4,9,5,0,27,43,38.6,"FW"
"Gianluca Scamacca","2019-2020",191,41,26,63.4,15,36.6,18,12,7,6,5,5,18,27.8,13,25,10,15,7,25,41,0,69,68,50.4,"FW"
"Alessandro Bassoli","2019-2020",0,2,1,50,1,50,15,12,8,7,0,4,6,66.7,2,17,12,5,19,34,82,0,26,18,59.1,"DF"
"Federico Melchiorri","2019-2020",95,27,13,48.1,14,51.9,21,10,9,9,3,5,9,55.6,4,12,2,10,7,28,18,0,48,64,42.9,"FW,MF"
"Felipe Curcio","2019-2020",22,13,11,84.6,2,15.4,9,5,6,3,0,4,9,44.4,5,6,2,4,5,14,2,0,5,3,62.5,"DF"
"Gennaro Tutino","2019-2020",119,34,12,35.3,22,64.7,6,4,2,2,2,1,5,20,4,8,0,8,3,9,2,0,7,18,28,"FW"
"Davide Agazzi","2019-2020",46,46,32,69.6,14,30.4,69,40,27,38,4,20,54,37,34,38,2,36,27,96,22,0,18,20,47.4,"MF"
"Theophilus Awua","2019-2020",20,37,26,70.3,11,29.7,20,12,9,11,0,4,14,28.6,10,11,5,6,11,31,4,0,4,10,28.6,"MF"
"Daniele Sciaudone","2019-2020",96,33,15,45.5,18,54.5,56,36,29,21,6,26,57,45.6,31,38,8,30,26,82,25,0,33,23,58.9,"MF"
"Luca Ranieri","2019-2020",4,7,5,71.4,2,28.6,19,13,14,5,0,9,12,75,3,14,10,4,16,35,61,2,23,19,54.8,"DF"
"Giovanni Crociata","2019-2020",164,77,46,59.7,31,40.3,26,16,7,15,4,9,28,32.1,19,21,2,19,15,41,7,0,17,19,47.2,"MF"
"Emanuele Terranova","2019-2020",0,4,2,50,2,50,18,14,12,5,1,10,17,58.8,7,15,10,5,35,53,95,0,48,35,57.8,"DF"
"Francesco Zampano","2019-2020",127,29,15,51.7,14,48.3,29,22,16,10,3,8,17,47.1,9,15,4,11,8,37,26,0,16,23,41,"DF,FW"
"Roberto Insigne","2019-2020",191,39,19,48.7,20,51.3,18,9,7,7,4,11,40,27.5,29,9,0,9,12,30,10,0,8,19,29.6,"MF,FW"
"Përparim Hetemaj","2019-2020",77,30,20,66.7,10,33.3,49,34,20,25,4,23,52,44.2,29,30,10,20,22,71,22,0,16,18,47.1,"MF"
"Luigi Canotto","2019-2020",212,61,27,44.3,34,55.7,8,6,3,3,2,1,18,5.6,17,10,1,9,6,14,3,0,11,22,33.3,"FW,MF"
"Riccardo Marchizza","2019-2020",56,11,7,63.6,4,36.4,18,18,11,6,1,12,21,57.1,9,17,1,16,25,43,32,0,33,13,71.7,"DF"
"Nicola Citro","2019-2020",62,9,4,44.4,5,55.6,3,2,1,2,0,1,4,25,3,5,0,5,2,5,1,0,2,13,13.3,"FW"
"Leo Štulac","2019-2020",7,14,12,85.7,2,14.3,28,20,8,17,3,10,33,30.3,23,17,3,14,24,52,28,1,18,20,47.4,"MF"
"Michele Rocca","2019-2020",45,26,12,46.2,14,53.8,11,9,6,5,0,0,10,0,10,9,3,6,3,14,6,0,5,15,25,"MF,FW"
"Matteo Ardemagni","2019-2020",78,10,5,50,5,50,8,6,3,4,1,5,14,35.7,9,9,3,6,0,8,18,0,27,43,38.6,"FW"
"Matteo Legittimo","2019-2020",15,16,11,68.8,5,31.3,34,23,18,10,6,14,23,60.9,9,23,13,10,32,66,96,2,16,17,48.5,"DF"
"Davide Di Gennaro","2019-2020",24,12,7,58.3,5,41.7,16,14,3,12,1,2,8,25,6,7,0,7,1,17,2,0,5,5,50,"MF,FW"
"Giulio Maggiore","2019-2020",124,44,30,68.2,14,31.8,42,29,14,19,9,15,41,36.6,26,28,2,26,23,65,14,0,18,27,40,"MF"
"Paweł Jaroszyński","2019-2020",10,19,16,84.2,3,15.8,32,19,20,11,1,8,16,50,8,33,15,18,56,88,108,3,50,36,58.1,"DF"
"Slobodan Rajković","2019-2020",1,1,1,100,0,0,11,7,5,6,0,3,9,33.3,6,5,4,1,8,19,14,1,20,13,60.6,"DF"
"Luca Antei","2019-2020",14,2,0,0,2,100,28,21,21,7,0,16,23,69.6,7,12,4,8,21,49,46,0,25,14,64.1,"DF"
"Samuele Ricci","2019-2020",30,21,16,76.2,5,23.8,49,34,14,32,3,13,30,43.3,17,21,4,17,31,80,21,0,14,13,51.9,"MF"
"Pasquale Fazio","2019-2020",23,10,2,20,8,80,37,27,28,8,1,12,19,63.2,7,27,16,11,33,70,71,1,26,27,49.1,"DF"
"Antonio Caracciolo","2019-2020",9,12,10,83.3,2,16.7,58,36,42,14,2,28,49,57.1,21,40,23,17,50,108,137,0,76,45,62.8,"DF"
"Filippo De Col","2019-2020",43,3,2,66.7,1,33.3,3,1,3,0,0,1,1,100,0,2,1,1,11,14,14,0,10,7,58.8,"DF"
"Alessandro Mallamo","2019-2020",78,55,27,49.1,28,50.9,45,33,15,25,5,16,39,41,23,24,1,23,14,59,18,0,9,37,19.6,"MF"
"Davide Diaw","2019-2020",266,89,41,46.1,48,53.9,34,26,4,21,9,7,24,29.2,17,49,3,46,6,40,44,0,130,125,51,"FW"
"Luca Fiordilino","2019-2020",45,48,33,68.8,15,31.3,58,44,30,21,7,25,55,45.5,30,34,14,20,34,92,44,0,23,30,43.4,"MF"
"Andrija Balić","2019-2020",7,9,8,88.9,1,11.1,8,4,4,3,1,3,13,23.1,10,5,1,4,4,12,5,0,5,4,55.6,"MF"
"Franco Zuculini","2019-2020",44,27,15,55.6,12,44.4,47,32,21,18,8,19,37,51.4,18,10,2,8,18,65,9,0,9,11,45,"MF"
"Samuel Armenteros","2019-2020",85,41,23,56.1,18,43.9,6,1,1,2,3,2,5,40,3,3,0,3,1,7,3,0,16,27,37.2,"FW"
"Raffaele Schiavi","2019-2020",0,2,1,50,1,50,8,4,8,0,0,4,5,80,1,3,2,1,8,16,26,0,20,7,74.1,"DF"
"Andrea Paolucci","2019-2020",65,29,18,62.1,11,37.9,101,63,51,46,4,36,98,36.7,62,48,9,39,43,144,52,0,28,31,47.5,"MF"
"Simone Calvano","2019-2020",6,7,6,85.7,1,14.3,26,17,16,10,0,10,18,55.6,8,14,10,4,19,45,30,0,31,29,51.7,"MF"
"Marco Pinato","2019-2020",72,24,10,41.7,14,58.3,28,21,10,14,4,11,23,47.8,12,31,9,22,6,34,20,0,48,45,51.6,"MF"
"Moustapha Seck","2019-2020",34,12,4,33.3,8,66.7,19,14,12,5,2,7,13,53.8,6,8,0,8,14,33,8,0,5,5,50,"DF,MF"
"Fabio Mazzeo","2019-2020",39,2,1,50,1,50,2,1,1,1,0,0,1,0,1,1,0,1,0,2,5,0,9,24,27.3,"FW"
"Andrea Bussaglia","2019-2020",37,5,2,40,3,60,9,5,1,5,3,3,8,37.5,5,15,1,14,9,18,5,0,8,9,47.1,"MF"
"Riccardo Fiamozzi","2019-2020",76,20,8,40,12,60,16,10,8,7,1,8,12,66.7,4,13,5,8,9,25,29,0,8,15,34.8,"DF"
"Mardochee Nzita","2019-2020",25,6,2,33.3,4,66.7,13,7,7,4,2,3,9,33.3,6,17,4,13,10,23,16,0,4,12,25,"DF"
"Christian Capone","2019-2020",98,16,8,50,8,50,16,11,4,8,4,4,13,30.8,9,9,1,8,5,21,4,0,3,21,12.5,"MF,FW"
"Ahmad Benali","2019-2020",173,22,11,50,11,50,36,19,14,17,5,13,46,28.3,33,20,4,16,15,51,20,1,30,31,49.2,"MF"
"Manuel Pucciarelli","2019-2020",63,12,5,41.7,7,58.3,10,3,4,5,1,6,17,35.3,11,8,1,7,4,14,4,0,6,22,21.4,"FW,MF"
"Diego Falcinelli","2019-2020",106,31,14,45.2,17,54.8,15,6,4,9,2,3,15,20,12,8,3,5,4,19,16,0,26,69,27.4,"FW,MF"
"Jean-Claude Billong","2019-2020",0,3,3,100,0,0,15,13,11,4,0,7,9,77.8,2,13,10,3,3,18,38,1,15,7,68.2,"DF"
"Guillaume Gigliotti","2019-2020",11,4,3,75,1,25,26,19,14,12,0,11,33,33.3,22,13,8,5,31,57,54,0,40,22,64.5,"DF"
"Tomislav Gomelt","2019-2020",16,8,4,50,4,50,6,4,2,2,2,3,10,30,7,7,2,5,5,11,4,0,10,9,52.6,"MF"
"Marius Marin","2019-2020",64,40,26,65,14,35,67,45,37,25,5,27,51,52.9,24,46,11,35,33,100,53,1,33,36,47.8,"MF"
"Antonio Balzano","2019-2020",23,6,2,33.3,4,66.7,15,7,8,6,1,7,10,70,3,4,3,1,8,23,13,0,6,6,50,"DF"
"Federico Dionisi","2019-2020",223,51,23,45.1,28,54.9,23,15,4,12,7,7,27,25.9,20,20,3,17,6,29,11,0,28,55,33.7,"FW"
"Andrija Novakovich","2019-2020",151,43,27,62.8,16,37.2,12,6,5,1,6,2,12,16.7,10,6,1,5,1,13,16,0,83,93,47.2,"FW"
"Fabrizio Melara","2019-2020",31,13,6,46.2,7,53.8,8,5,6,2,0,1,6,16.7,5,5,0,5,4,12,5,1,2,5,28.6,"FW,MF"
"Felice Evacuo","2019-2020",35,1,0,0,1,100,3,2,1,1,1,1,6,16.7,5,2,1,1,1,4,8,0,33,41,44.6,"FW"
"Nikola Ninković","2019-2020",156,49,30,61.2,19,38.8,18,9,7,8,3,4,33,12.1,29,13,0,13,11,29,5,1,10,22,31.3,"MF,FW"
"Moses Odjer","2019-2020",28,5,3,60,2,40,15,8,4,7,4,5,12,41.7,7,9,3,6,15,30,10,0,17,8,68,"MF"
"Marcello Trotta","2019-2020",112,21,15,71.4,6,28.6,11,8,2,7,2,4,12,33.3,8,10,1,9,5,16,13,0,22,33,40,"FW,MF"
"Matteo Brunori","2019-2020",41,7,2,28.6,5,71.4,3,1,1,1,1,1,6,16.7,5,6,0,6,2,5,5,0,21,27,43.8,"FW"
"Michele Castagnetti","2019-2020",23,13,8,61.5,5,38.5,49,28,20,25,4,17,46,37,29,12,3,9,35,84,37,0,14,13,51.9,"MF"
"Giuseppe Cuomo","2019-2020",18,11,7,63.6,4,36.4,41,28,27,14,0,15,25,60,10,22,6,16,30,71,54,1,54,23,70.1,"DF"
"Leonardo Candellone","2019-2020",155,15,7,46.7,8,53.3,7,5,1,2,4,2,9,22.2,7,9,1,8,3,10,18,0,32,95,25.2,"FW"
"Mattia Mustacchio","2019-2020",187,28,17,60.7,11,39.3,24,13,15,7,2,12,26,46.2,14,14,0,14,9,33,23,0,14,23,37.8,"DF"
"Andrea Luci","2019-2020",33,24,20,83.3,4,16.7,44,30,22,17,5,19,53,35.8,34,41,12,29,33,77,28,0,26,27,49.1,"MF"
"Cristiano Del Grosso","2019-2020",34,2,1,50,1,50,18,10,13,5,0,13,22,59.1,9,7,3,4,14,32,26,0,5,7,41.7,"DF"
"Marco Carraro","2019-2020",10,17,13,76.5,4,23.5,44,29,20,17,7,18,42,42.9,24,37,15,22,63,107,47,0,48,36,57.1,"MF"
"Daniel Ciofani","2019-2020",149,11,3,27.3,8,72.7,10,9,2,4,4,4,16,25,12,14,4,10,6,16,43,0,111,108,50.7,"FW"
"Hans Nicolussi Caviglia","2019-2020",72,51,23,45.1,28,54.9,25,12,12,8,5,7,25,28,18,18,3,15,6,31,11,0,20,18,52.6,"MF"
"Samuel Gustafson","2019-2020",21,7,5,71.4,2,28.6,12,6,5,6,1,5,20,25,15,15,2,13,22,34,22,2,18,21,46.2,"MF"
"Karamoko Cissé","2019-2020",52,16,11,68.8,5,31.3,7,6,4,1,2,0,4,0,4,8,0,8,2,9,7,1,25,39,39.1,"FW"
"Matteo Bianchetti","2019-2020",30,12,8,66.7,4,33.3,75,58,45,22,8,36,58,62.1,22,53,23,30,50,125,137,0,89,31,74.2,"DF"
"Mirko Drudi","2019-2020",2,10,8,80,2,20,56,46,41,14,1,20,31,64.5,11,22,15,7,46,102,87,0,59,35,62.8,"DF"
"Manuel Iori","2019-2020",37,9,8,88.9,1,11.1,34,23,13,16,5,10,26,38.5,16,24,8,16,37,71,39,2,43,30,58.9,"MF"
"Andrea Tabanelli","2019-2020",27,9,7,77.8,2,22.2,11,8,5,3,3,2,8,25,6,8,1,7,2,13,9,0,13,7,65,"MF"
"Marcus Rohdén","2019-2020",131,25,14,56,11,44,47,29,14,29,4,25,52,48.1,27,24,6,18,32,79,27,0,25,28,47.2,"MF"
"Francesco Di Tacchio","2019-2020",20,19,11,57.9,8,42.1,56,40,31,23,2,19,47,40.4,28,39,11,28,42,98,34,0,64,59,52,"MF"
"Alessio da Cruz","2019-2020",103,73,44,60.3,29,39.7,6,4,2,3,1,2,7,28.6,5,7,1,6,2,8,1,0,6,16,27.3,"FW,MF"
"Fausto Grillo","2019-2020",41,48,25,52.1,23,47.9,55,38,25,26,4,26,48,54.2,22,42,7,35,33,88,48,0,52,22,70.3,"DF"
"Alessandro Coppola","2019-2020",0,2,1,50,1,50,4,1,3,1,0,2,3,66.7,1,14,10,4,8,12,31,0,11,6,64.7,"DF"
"Michele Rigione","2019-2020",6,4,2,50,2,50,23,13,15,7,1,12,19,63.2,7,17,15,2,16,39,64,1,54,32,62.8,"DF"
"Michele Cavion","2019-2020",131,56,40,71.4,16,28.6,55,31,26,23,6,25,69,36.2,44,27,5,22,17,72,30,1,20,40,33.3,"MF"
"Amedeo Benedetti","2019-2020",135,17,7,41.2,10,58.8,32,25,16,13,3,17,32,53.1,15,26,2,24,22,54,64,0,7,14,33.3,"DF"
"Giuseppe Panico","2019-2020",61,17,10,58.8,7,41.2,10,6,1,5,4,1,12,8.3,11,9,0,9,4,14,2,0,5,26,16.1,"MF,FW"
"Andrea Schenetti","2019-2020",224,63,43,68.3,20,31.7,21,15,13,4,4,6,19,31.6,13,18,3,15,8,29,17,0,7,32,17.9,"MF"
"Lorenzo Gonnelli","2019-2020",6,2,2,100,0,0,15,10,12,2,1,5,8,62.5,3,17,8,9,33,48,44,2,27,19,58.7,"DF"
"Davide Marsura","2019-2020",236,100,60,60,40,40,20,10,7,5,8,7,18,38.9,11,5,0,5,3,23,5,0,13,11,54.2,"MF,FW"
"Giovanni Di Noia","2019-2020",17,5,3,60,2,40,9,7,5,4,0,3,5,60,2,10,1,9,15,24,13,0,14,15,48.3,"MF,DF"
"Pasquale Schiattarella","2019-2020",28,18,13,72.2,5,27.8,29,19,11,16,2,16,37,43.2,21,19,6,13,32,61,24,0,10,14,41.7,"MF"
"Marco Moscati","2019-2020",51,16,8,50,8,50,26,18,11,10,5,9,20,45,11,25,7,18,17,43,27,1,15,16,48.4,"MF,DF"
"Christian Kouan","2019-2020",30,12,12,100,0,0,19,15,8,7,4,8,20,40,12,14,5,9,10,29,7,0,13,26,33.3,"MF"
"Boštjan Cesar","2019-2020",2,2,2,100,0,0,28,17,15,10,3,10,19,52.6,9,27,16,11,22,50,82,0,39,33,54.2,"DF"
"Luca Vignali","2019-2020",34,15,6,40,9,60,16,12,12,4,0,6,16,37.5,10,8,5,3,16,32,36,0,21,12,63.6,"DF"
"Andrea La Mantia","2019-2020",37,1,1,100,0,0,0,0,0,0,0,0,2,0,2,2,0,2,0,0,14,0,34,18,65.4,"FW"
"Gianmarco Ingrosso","2019-2020",0,5,3,60,2,40,18,13,14,4,0,3,10,30,7,7,3,4,21,39,34,0,22,15,59.5,"DF"
"Gabriele Moncini","2019-2020",49,9,5,55.6,4,44.4,4,2,1,3,0,2,4,50,2,5,1,4,3,7,8,0,41,38,51.9,"FW"
"Murilo Otávio Mendes","2019-2020",87,22,8,36.4,14,63.6,22,13,5,13,4,9,16,56.3,7,11,1,10,4,26,6,0,22,55,28.6,"FW,MF"
"Adriano Mezavilla","2019-2020",3,4,1,25,3,75,8,7,8,0,0,7,12,58.3,5,4,4,0,2,10,31,0,18,9,66.7,"DF"
"Luca Crecco","2019-2020",47,17,6,35.3,11,64.7,16,12,9,4,3,6,18,33.3,12,13,4,9,10,26,28,0,12,18,40,"DF,MF"
"Mamadou Coulibaly","2019-2020",67,26,17,65.4,9,34.6,32,25,10,14,8,7,28,25,21,21,0,21,21,53,6,0,24,21,53.3,"MF"
"Luka Bogdan","2019-2020",8,4,3,75,1,25,34,23,14,18,2,11,23,47.8,12,61,37,24,66,100,148,0,110,68,61.8,"DF"
"Marco Varnier","2019-2020",1,3,1,33.3,2,66.7,14,8,8,6,0,1,5,20,4,11,6,5,10,24,41,0,35,17,67.3,"DF"
"Alessandro Rossi","2019-2020",28,11,7,63.6,4,36.4,10,9,4,3,3,3,7,42.9,4,6,2,4,2,12,4,0,19,35,35.2,"FW,MF"
"Gennaro Scognamiglio","2019-2020",6,2,2,100,0,0,29,21,21,8,0,13,21,61.9,8,23,12,11,23,52,136,0,85,28,75.2,"DF"
"Sofian Kiyine","2019-2020",146,126,83,65.9,43,34.1,46,33,35,10,1,18,38,47.4,20,23,4,19,25,71,23,0,11,26,29.7,"DF,MF"
"Simone Branca","2019-2020",129,24,16,66.7,8,33.3,101,73,50,30,21,37,92,40.2,55,63,4,59,23,124,27,0,38,43,46.9,"MF"
"Dimitris Nikolaou","2019-2020",1,1,0,0,1,100,11,9,4,6,1,3,6,50,3,10,8,2,10,21,46,1,22,22,50,"DF"
"Giacomo Ricci","2019-2020",61,43,19,44.2,24,55.8,47,33,28,15,4,17,50,34,33,33,6,27,28,75,45,0,13,24,35.1,"DF"
"Simone Palombi","2019-2020",140,35,13,37.1,22,62.9,10,6,4,4,2,2,12,16.7,10,6,0,6,5,15,10,0,12,33,26.7,"FW,MF"
"Karim Laribi","2019-2020",43,19,14,73.7,5,26.3,7,4,3,4,0,3,8,37.5,5,3,1,2,2,9,1,0,1,8,11.1,"MF"
"Mirko Eramo","2019-2020",77,22,9,40.9,13,59.1,44,33,21,15,8,18,50,36,32,43,7,36,32,76,30,0,65,44,59.6,"MF"
"Riccardo Maniero","2019-2020",96,14,6,42.9,8,57.1,8,6,2,6,0,3,12,25,9,12,2,10,6,14,19,0,64,70,47.8,"FW"
"Giacomo Calò","2019-2020",40,28,12,42.9,16,57.1,55,41,21,30,4,27,45,60,18,24,10,14,38,93,44,1,22,26,45.8,"MF"
"Francesco Lisi","2019-2020",207,82,37,45.1,45,54.9,33,16,18,12,3,17,40,42.5,23,17,5,12,26,59,46,0,27,28,49.1,"DF"
"Antonio Candela","2019-2020",20,8,4,50,4,50,11,6,8,3,0,4,9,44.4,5,0,0,0,6,17,13,0,2,4,33.3,"DF"
"Filippo Bandinelli","2019-2020",112,46,26,56.5,20,43.5,31,19,6,18,7,13,41,31.7,28,23,2,21,15,46,33,4,11,25,30.6,"MF"
"Freddie Veseli","2019-2020",55,9,4,44.4,5,55.6,22,15,8,10,4,11,24,45.8,13,13,7,6,19,41,33,0,4,17,19,"DF"
"Christian D'Urso","2019-2020",122,78,59,75.6,19,24.4,34,24,13,13,8,6,18,33.3,12,22,0,22,8,42,2,0,8,19,29.6,"MF"
"Matteo Di Gennaro","2019-2020",5,3,2,66.7,1,33.3,15,10,5,10,0,5,7,71.4,2,22,9,13,24,39,76,1,30,37,44.8,"DF"
"Liam Henderson","2019-2020",47,10,5,50,5,50,9,5,2,6,1,1,10,10,9,6,1,5,2,11,5,0,5,7,41.7,"MF"
"Leonardo Morosini","2019-2020",68,20,14,70,6,30,17,12,3,12,2,4,9,44.4,5,3,0,3,11,28,3,1,6,28,17.6,"MF,FW"
"Matteo Ciofani","2019-2020",35,17,8,47.1,9,52.9,10,6,4,5,1,4,6,66.7,2,8,3,5,9,19,33,0,5,8,38.5,"DF"
"Alessandro Capello","2019-2020",246,73,34,46.6,39,53.4,34,22,9,18,7,11,35,31.4,24,30,3,27,12,46,21,0,25,66,27.5,"FW,MF"
"Niccolò Giannetti","2019-2020",68,9,2,22.2,7,77.8,6,2,3,2,1,1,2,50,1,6,4,2,2,8,10,0,29,31,48.3,"FW"
"Michael Fabbro","2019-2020",61,10,4,40,6,60,8,7,2,4,2,2,8,25,6,4,0,4,3,11,6,0,10,28,26.3,"FW"
"Luca Mazzitelli","2019-2020",88,14,8,57.1,6,42.9,37,20,13,22,2,12,33,36.4,21,26,2,24,28,65,27,0,54,36,60,"MF"
"Leonardo Sernicola","2019-2020",51,23,15,65.2,8,34.8,35,20,19,11,5,12,24,50,12,18,4,14,24,59,42,0,24,19,55.8,"DF"
"Nicholas Allievi","2019-2020",6,3,1,33.3,2,66.7,3,2,3,0,0,2,6,33.3,4,9,5,4,22,25,27,0,23,14,62.2,"DF"
"Domenico Frare","2019-2020",5,3,2,66.7,1,33.3,29,21,21,8,0,13,24,54.2,11,21,14,7,45,74,76,1,46,23,66.7,"DF"
"Filip Đorđević","2019-2020",173,24,7,29.2,17,70.8,11,10,2,5,4,1,20,5,19,15,1,14,5,16,24,0,57,74,43.5,"FW"
"Jaime Báez","2019-2020",263,82,51,62.2,31,37.8,27,19,12,10,5,11,35,31.4,24,44,2,42,10,37,10,0,22,40,35.5,"FW,DF"
"Gianvito Misuraca","2019-2020",91,13,6,46.2,7,53.8,30,21,15,10,5,13,26,50,13,29,8,21,21,51,31,0,18,23,43.9,"MF"
"Davide Adorni","2019-2020",0,6,5,83.3,1,16.7,62,36,32,27,3,30,46,65.2,16,29,14,15,48,110,99,3,98,57,63.2,"DF"
"Christian Mora","2019-2020",55,17,6,35.3,11,64.7,28,19,14,8,6,12,20,60,8,14,4,10,17,45,35,0,18,24,42.9,"DF"
"Luca Paganini","2019-2020",98,7,3,42.9,4,57.1,26,14,10,14,2,10,28,35.7,18,19,3,16,18,44,25,0,61,69,46.9,"DF,MF"
"Franco Ferrari","2019-2020",41,10,3,30,7,70,8,8,1,6,1,2,8,25,6,4,1,3,2,10,0,0,22,28,44,"FW"
"Kingsley Michael","2019-2020",23,6,3,50,3,50,14,6,8,2,4,4,10,40,6,7,2,5,1,15,0,0,1,7,12.5,"MF"
"Milos Bocic","2019-2020",67,19,10,52.6,9,47.4,5,4,2,2,1,0,5,0,5,5,0,5,0,5,0,0,4,7,36.4,"FW,MF"
"Alberto Gerbo","2019-2020",93,18,11,61.1,7,38.9,39,23,17,15,7,17,50,34,33,26,9,17,19,58,28,1,11,14,44,"DF"
"Jacopo Dezi","2019-2020",142,50,26,52,24,48,55,31,24,25,6,21,46,45.7,25,21,1,20,35,90,23,1,8,35,18.6,"MF"
"Antonino Ragusa","2019-2020",141,21,12,57.1,9,42.9,10,6,3,5,2,5,12,41.7,7,17,2,15,6,16,4,0,12,13,48,"FW"
"Salvatore Elia","2019-2020",81,55,29,52.7,26,47.3,36,26,22,12,2,10,21,47.6,11,16,0,16,18,54,8,0,5,13,27.8,"FW,DF"
"Luca Marrone","2019-2020",1,8,6,75,2,25,32,20,18,14,0,16,27,59.3,11,31,23,8,42,74,76,2,51,31,62.2,"DF"
"Damir Ceter","2019-2020",86,46,27,58.7,19,41.3,6,3,2,2,2,2,4,50,2,11,0,11,1,7,10,0,20,48,29.4,"FW"
"Adriano Montalto","2019-2020",70,6,1,16.7,5,83.3,7,6,1,2,4,3,8,37.5,5,8,2,6,3,10,6,0,36,48,42.9,"FW"
"Luca Vido","2019-2020",137,42,22,52.4,20,47.6,14,12,2,8,4,2,11,18.2,9,18,1,17,8,22,2,0,18,48,27.3,"FW"
"Pasquale Mazzocchi","2019-2020",147,44,24,54.5,20,45.5,29,17,18,7,4,17,30,56.7,13,20,5,15,24,53,54,1,36,32,52.9,"DF,FW"
"Salvador Ferrer","2019-2020",83,41,27,65.9,14,34.1,42,30,30,10,2,17,28,60.7,11,28,7,21,45,87,77,0,63,45,58.3,"DF"
"Emanuel Vignato","2019-2020",213,73,46,63,27,37,33,18,12,12,9,8,37,21.6,29,15,0,15,11,44,5,1,7,17,29.2,"MF,FW"
"Edoardo Masciangelo","2019-2020",92,24,12,50,12,50,27,21,18,7,2,17,36,47.2,19,17,3,14,24,51,35,0,21,14,60,"DF"
"Luca Tremolada","2019-2020",51,8,5,62.5,3,37.5,9,6,5,3,1,4,12,33.3,8,7,0,7,3,12,2,0,1,4,20,"MF"
"Salvatore Burrai","2019-2020",29,6,4,66.7,2,33.3,45,28,19,22,4,22,55,40,33,28,12,16,44,89,46,0,25,37,40.3,"MF"
"Cristiano Lombardi","2019-2020",118,75,39,52,36,48,24,16,14,9,1,10,24,41.7,14,15,1,14,8,32,20,0,9,3,75,"DF,FW"
"Maxime Leverbe","2019-2020",5,12,10,83.3,2,16.7,32,19,20,10,2,15,30,50,15,24,20,4,35,67,117,0,79,48,62.2,"DF"
"Alberto Almici","2019-2020",46,12,8,66.7,4,33.3,29,19,18,9,2,13,26,50,13,18,4,14,15,44,30,0,10,18,35.7,"DF"
"Andrea Di Grazia","2019-2020",53,19,13,68.4,6,31.6,6,4,2,2,2,1,5,20,4,0,0,0,1,7,3,0,1,5,16.7,"FW,MF"
"Cristian Buonaiuto","2019-2020",176,67,36,53.7,31,46.3,19,11,6,8,5,6,24,25,18,15,1,14,6,25,14,0,9,23,28.1,"MF,FW"
"Nedim Bajrami","2019-2020",178,69,37,53.6,32,46.4,14,7,3,7,4,3,15,20,12,7,0,7,4,18,7,0,6,19,24,"FW,MF"
"Francesco Renzetti","2019-2020",89,30,14,46.7,16,53.3,35,27,19,15,1,20,34,58.8,14,26,4,22,16,51,45,0,11,11,50,"DF"
"Luigi Scaglia","2019-2020",36,4,3,75,1,25,6,5,3,3,0,3,8,37.5,5,16,3,13,4,10,6,0,0,6,0,"MF,FW"
"Junior Messias","2019-2020",314,103,72,69.9,31,30.1,49,31,18,20,11,22,49,44.9,27,34,3,31,19,68,10,0,40,67,37.4,"FW,MF"
"Mariano Arini","2019-2020",46,19,13,68.4,6,31.6,52,33,30,14,8,21,52,40.4,31,20,7,13,20,72,35,0,42,39,51.9,"MF"
"Riccardo Improta","2019-2020",147,46,27,58.7,19,41.3,27,20,16,9,2,19,32,59.4,13,24,2,22,18,45,21,0,27,31,46.6,"MF,FW"
"Sergiu Suciu","2019-2020",31,4,2,50,2,50,16,10,8,7,1,7,12,58.3,5,5,0,5,3,19,8,0,1,5,16.7,"MF"
"Roberto Vitiello","2019-2020",53,4,4,100,0,0,42,31,27,14,1,20,34,58.8,14,28,15,13,43,85,92,0,31,29,51.7,"DF"
"Emmanuel Gyasi","2019-2020",274,42,26,61.9,16,38.1,27,14,15,9,3,8,19,42.1,11,23,4,19,12,39,7,0,19,61,23.8,"FW"
"Nicolas Haas","2019-2020",76,10,8,80,2,20,52,33,25,24,3,15,49,30.6,34,33,6,27,34,86,16,0,16,25,39,"MF"
"Anthony Taugourdeau","2019-2020",41,35,21,60,14,40,49,34,24,21,4,16,64,25,48,45,10,35,49,98,41,1,30,17,63.8,"MF"
"Alessandro Crescenzi","2019-2020",25,10,5,50,5,50,13,9,9,3,1,5,9,55.6,4,7,0,7,7,20,29,0,9,5,64.3,"DF"
"Massimiliano Carlini","2019-2020",13,11,8,72.7,3,27.3,13,8,6,6,1,5,17,29.4,12,5,2,3,11,24,8,0,6,4,60,"MF,FW"
"Marco Chiosa","2019-2020",2,2,0,0,2,100,27,14,17,9,1,9,19,47.4,10,36,26,10,49,76,141,0,74,53,58.3,"DF"
"Bright Addae","2019-2020",36,19,16,84.2,3,15.8,21,12,10,10,1,6,21,28.6,15,32,9,23,34,55,43,1,77,43,64.2,"MF"
"Lorenzo Del Prete","2019-2020",74,27,9,33.3,18,66.7,13,9,8,2,3,6,14,42.9,8,13,3,10,3,16,30,0,20,19,51.3,"DF"
"Marco Modolo","2019-2020",24,6,4,66.7,2,33.3,27,19,18,9,0,15,20,75,5,29,22,7,24,51,117,1,82,56,59.4,"DF"
"Jean-Daniel Akpa-Akpro","2019-2020",69,79,51,64.6,28,35.4,90,69,55,27,8,30,53,56.6,23,42,11,31,46,136,22,0,32,31,50.8,"MF"
"Mario Piccinocchi","2019-2020",19,2,2,100,0,0,10,5,2,6,2,3,16,18.8,13,18,3,15,11,21,9,0,3,11,21.4,"MF"
"Filip Raičević","2019-2020",48,11,4,36.4,7,63.6,4,3,3,1,0,1,2,50,1,5,1,4,3,7,6,0,35,51,40.7,"FW"
"Gian Filippo Felicioli","2019-2020",9,9,6,66.7,3,33.3,5,4,4,0,1,4,6,66.7,2,2,0,2,3,8,14,0,2,4,33.3,"DF"
"Cedric Gondo","2019-2020",136,36,27,75,9,25,15,11,6,7,2,1,6,16.7,5,17,5,12,3,18,17,0,53,56,48.6,"FW"
"Aníbal Capela","2019-2020",0,8,7,87.5,1,12.5,21,13,12,9,0,9,21,42.9,12,21,15,6,30,51,105,0,49,32,60.5,"DF"
"Cesar Falletti","2018-2019",229,48,25,52.1,23,47.9,30,23,8,14,8,7,24,29.2,17,23,1,22,5,35,4,0,4,13,23.5,"MF"
"Andrea Gasbarro","2018-2019",26,12,7,58.3,5,41.7,15,10,12,2,1,10,18,55.6,8,12,5,7,18,33,40,0,16,18,47.1,"DF,MF"
"Michel Morganella","2018-2019",21,5,0,0,5,100,13,11,6,6,1,10,34,29.4,24,12,3,9,19,32,42,0,17,14,54.8,"DF"
"Daniele Dessena","2018-2019",34,12,9,75,3,25,6,5,0,6,0,3,11,27.3,8,10,3,7,4,10,16,0,10,7,58.8,"MF"
"Matteo Bruscagin","2018-2019",95,11,6,54.5,5,45.5,51,39,32,15,4,26,43,60.5,17,47,10,37,49,100,106,0,47,35,57.3,"DF"
"Michele Camporese","2018-2019",1,1,1,100,0,0,4,3,2,2,0,0,0,NA,0,13,11,2,11,15,39,0,23,14,62.2,"DF"
"Matteo Rubin","2018-2019",36,10,9,90,1,10,16,13,7,7,2,5,10,50,5,7,2,5,24,40,29,0,12,8,60,"DF"
"Maicon da Silva","2018-2019",36,9,6,66.7,3,33.3,8,5,5,1,2,2,2,100,0,6,1,5,4,12,9,0,8,14,36.4,"DF,MF"
"Gaetano Castrovilli","2018-2019",178,75,36,48,39,52,35,26,12,17,6,10,24,41.7,14,24,1,23,20,55,19,0,36,40,47.4,"MF"
"Romano Perticone","2018-2019",2,1,0,0,1,100,22,19,12,10,0,8,12,66.7,4,9,3,6,27,49,46,0,14,8,63.6,"DF"
"Antonio Nocerino","2018-2019",11,3,2,66.7,1,33.3,7,5,2,5,0,4,5,80,1,6,3,3,3,10,9,0,3,4,42.9,"MF"
"Lorenzo Del Pinto","2018-2019",21,2,2,100,0,0,27,21,9,17,1,10,25,40,15,21,4,17,20,47,11,0,10,14,41.7,"MF,DF"
"Pietro Iemmello","2018-2019",141,25,14,56,11,44,9,7,2,3,4,4,14,28.6,10,7,1,6,4,13,14,0,35,41,46.1,"FW"
"Danilo Soddimo","2018-2019",46,19,14,73.7,5,26.3,12,6,5,5,2,2,15,13.3,13,10,0,10,18,30,10,0,18,11,62.1,"MF"
"Simone Romagnoli","2018-2019",9,5,3,60,2,40,34,25,22,10,2,13,21,61.9,8,52,39,13,36,70,241,0,110,55,66.7,"DF"
"Andrey Galabinov","2018-2019",131,16,12,75,4,25,8,6,3,5,0,2,5,40,3,8,2,6,0,8,19,0,57,55,50.9,"FW"
"Benjamin Mokulu","2018-2019",60,8,0,0,8,100,4,3,1,1,2,1,2,50,1,3,0,3,4,8,27,0,28,43,39.4,"FW"
"Radosław Murawski","2018-2019",53,8,6,75,2,25,25,16,6,13,6,7,34,20.6,27,45,8,37,22,47,25,0,9,25,26.5,"MF"
"Fabrizio Poli","2018-2019",14,8,2,25,6,75,35,21,23,11,1,15,28,53.6,13,45,34,11,47,82,126,0,73,38,65.8,"DF"
"Norbert Gyömbér","2018-2019",5,9,9,100,0,0,40,35,33,6,1,17,25,68,8,36,27,9,41,81,203,1,64,27,70.3,"DF"
"Stefano Sabelli","2018-2019",106,35,17,48.6,18,51.4,61,39,37,20,4,24,54,44.4,30,34,5,29,62,123,99,0,26,23,53.1,"DF"
"Federico Casarini","2018-2019",17,5,4,80,1,20,13,9,4,9,0,2,12,16.7,10,13,3,10,18,31,24,0,10,9,52.6,"MF"
"Leandro Greco","2018-2019",15,31,23,74.2,8,25.8,33,23,19,13,1,15,49,30.6,34,22,5,17,43,76,17,0,5,10,33.3,"MF"
"Sandro Tonali","2018-2019",30,33,23,69.7,10,30.3,38,26,13,21,4,11,44,25,33,35,14,21,63,101,69,0,17,15,53.1,"MF"
"Lee Seung-woo","2018-2019",120,47,31,66,15,31.9,11,6,3,5,3,1,23,4.3,22,13,2,11,15,26,8,0,3,18,14.3,"FW,MF"
"Michele Troiano","2018-2019",11,8,5,62.5,3,37.5,55,38,32,23,0,18,62,29,44,30,7,23,46,101,59,0,31,18,63.3,"MF"
"Joseph Minala","2018-2019",12,10,7,70,3,30,17,13,5,11,1,6,18,33.3,12,5,2,3,15,32,9,0,14,12,53.8,"MF"
"Lorenzo Lollo","2018-2019",18,18,9,50,9,50,40,31,16,23,1,15,29,51.7,14,18,3,15,21,61,14,0,22,10,68.8,"MF"
"Emanuele Padella","2018-2019",2,2,1,50,1,50,13,11,10,3,0,6,9,66.7,3,21,16,5,25,38,95,0,28,30,48.3,"DF"
"Daniele Gastaldello","2018-2019",0,1,1,100,0,0,8,4,3,3,2,1,5,20,4,13,9,4,13,21,58,1,36,15,70.6,"DF"
"Raffaele Bianco","2018-2019",22,6,3,50,3,50,38,26,18,20,0,10,33,30.3,23,20,3,17,23,61,39,0,22,14,61.1,"MF"
"Alessandro Longhi","2018-2019",29,10,5,50,5,50,11,6,8,2,1,4,7,57.1,3,18,8,10,22,33,41,0,10,5,66.7,"DF"
"Tomasz Kupisz","2018-2019",51,11,3,27.3,8,72.7,12,11,6,5,1,6,12,50,6,8,2,6,15,27,22,0,19,18,51.4,"DF,FW"
"Dimitri Bisoli","2018-2019",224,69,39,56.5,30,43.5,95,75,42,38,15,29,62,46.8,33,66,11,55,51,146,27,0,44,57,43.6,"MF"
"Paweł Dawidowicz","2018-2019",8,12,5,41.7,7,58.3,23,16,13,10,0,5,15,33.3,10,27,15,12,31,54,136,0,76,37,67.3,"DF,MF"
"Xian Emmers","2018-2019",52,22,12,54.5,10,45.5,18,12,6,11,1,4,12,33.3,8,11,1,10,11,29,11,0,5,20,20,"MF"
"Elio Capradossi","2018-2019",2,1,1,100,0,0,17,12,14,3,0,6,13,46.2,7,23,17,6,55,72,77,0,55,39,58.5,"DF"
"Eyob Zambataro","2018-2019",27,6,5,83.3,1,16.7,18,13,10,7,1,5,9,55.6,4,12,1,11,14,32,26,0,6,7,46.2,"DF,FW"
"Riccardo Idda","2018-2019",2,2,1,50,1,50,11,10,6,5,0,3,8,37.5,5,13,11,2,24,35,67,0,47,31,60.3,"DF"
"Francesco Migliore","2018-2019",99,36,21,58.3,15,41.7,21,14,14,5,2,9,20,45,11,18,4,14,47,68,60,0,21,22,48.8,"DF"
"Jure Balkovec","2018-2019",54,9,4,44.4,5,55.6,28,22,13,13,2,17,23,73.9,6,12,5,7,22,50,35,0,15,18,45.5,"DF"
"Alessandro Ligi","2018-2019",1,3,3,100,0,0,17,14,12,5,0,8,10,80,2,11,5,6,20,37,40,0,21,9,70,"DF"
"Amato Ciciretti","2018-2019",66,21,12,57.1,9,42.9,22,11,8,11,3,7,15,46.7,8,16,1,15,6,28,3,0,2,16,11.1,"MF,FW"
"Jérémie Broh","2018-2019",24,5,5,100,0,0,5,3,2,3,0,2,3,66.7,1,9,4,5,8,13,15,0,2,4,33.3,"MF"
"Hrvoje Milić","2018-2019",50,8,5,62.5,3,37.5,8,5,3,3,2,3,7,42.9,4,2,0,2,5,13,7,0,3,4,42.9,"DF"
"Aleandro Rosi","2018-2019",39,17,11,64.7,6,35.3,14,13,9,5,0,2,10,20,8,13,1,12,13,27,30,0,23,7,76.7,"DF"
"Roberto Pirrello","2018-2019",7,1,1,100,0,0,10,10,5,4,1,5,7,71.4,2,1,0,1,13,23,22,0,18,9,66.7,"DF"
"Oliver Kragl","2018-2019",203,69,38,55.1,31,44.9,55,41,35,15,5,28,56,50,28,35,3,32,38,93,44,0,30,41,42.3,"DF,MF"
"Antonio Piccolo","2018-2019",137,63,40,63.5,23,36.5,15,9,7,4,4,4,18,22.2,14,15,1,14,3,18,5,0,6,13,31.6,"FW,MF"
"Andrea Settembrini","2018-2019",127,29,16,55.2,11,37.9,48,29,14,22,12,20,48,41.7,28,31,3,28,36,84,13,0,17,36,32.1,"MF"
"Filippo Sgarbi","2018-2019",1,7,6,85.7,1,14.3,15,9,10,5,0,8,14,57.1,6,17,10,7,14,29,40,0,15,16,48.4,"DF"
"Luca Garritano","2018-2019",106,22,4,18.2,18,81.8,16,12,6,9,1,6,23,26.1,17,17,5,12,11,27,8,0,2,21,8.7,"MF,FW"
"Vladimir Golemić","2018-2019",5,6,5,83.3,1,16.7,20,14,12,5,3,7,11,63.6,4,22,12,10,36,56,76,0,33,27,55,"DF"
"Roberto Crivello","2018-2019",23,3,2,66.7,1,33.3,16,10,10,4,2,3,7,42.9,4,6,2,4,19,35,24,0,12,11,52.2,"DF"
"Walter López","2018-2019",77,10,6,60,4,40,9,8,6,2,1,4,14,28.6,10,10,1,9,13,22,28,1,17,6,73.9,"DF"
"Alessandro Salvi","2018-2019",93,27,12,44.4,15,55.6,32,23,22,9,1,17,30,56.7,13,30,4,26,28,60,31,0,27,20,57.4,"DF"
"Alessandro Rosina","2018-2019",81,17,10,58.8,7,41.2,5,4,3,2,0,1,7,14.3,6,3,0,3,4,9,1,0,0,8,0,"MF,FW"
"Luca Caldirola","2018-2019",6,2,1,50,1,50,20,17,12,8,0,8,14,57.1,6,7,4,3,17,37,50,0,22,17,56.4,"DF"
"Sauli Väisänen","2018-2019",8,6,4,66.7,2,33.3,32,22,21,10,1,16,19,84.2,3,24,17,7,38,70,135,1,60,46,56.6,"DF"
"Stefano Pettinari","2018-2019",121,27,14,51.9,13,48.1,17,13,1,8,8,3,17,17.6,14,12,1,11,5,22,4,0,19,30,38.8,"FW"
"Gaetano Monachello","2018-2019",101,21,13,61.9,8,38.1,12,6,1,9,2,4,18,22.2,14,10,1,9,0,12,0,0,21,46,31.3,"FW"
"Luca Verna","2018-2019",8,2,0,0,2,100,4,3,0,3,1,0,3,0,3,3,1,2,4,8,3,0,3,7,30,"MF"
"Bright Gyamfi","2018-2019",25,7,5,71.4,2,28.6,12,11,7,5,0,8,13,61.5,5,5,0,5,11,23,18,0,9,4,69.2,"DF"
"Trevor Trevisan","2018-2019",8,2,1,50,1,50,24,17,15,9,0,8,14,57.1,6,28,13,15,50,74,160,0,51,27,65.4,"DF"
"Simone Andrea Ganz","2018-2019",36,1,0,0,1,100,2,1,0,2,0,1,3,33.3,2,3,0,3,0,2,1,0,6,14,30,"FW"
"Pierre-Yves Ngawa","2018-2019",36,5,2,40,3,60,36,30,27,8,1,16,24,66.7,8,13,4,9,30,66,61,1,26,25,51,"DF"
"Andrea Danzi","2018-2019",21,8,3,37.5,5,62.5,5,3,1,4,0,1,9,11.1,8,7,4,3,4,9,15,0,3,3,50,"MF"
"Tommaso Cancellotti","2018-2019",31,14,8,57.1,6,42.9,27,18,17,8,2,11,20,55,9,13,4,9,22,49,53,0,17,28,37.8,"DF"
"Vlad Dragomir","2018-2019",91,33,13,39.4,20,60.6,73,48,28,35,10,21,56,37.5,35,55,10,45,50,123,52,0,24,27,47.1,"MF"
"Davide Frattesi","2018-2019",93,56,27,48.2,29,51.8,36,27,15,15,6,7,25,28,18,33,1,32,21,57,35,0,32,33,49.2,"MF"
"Hugo Campagnaro","2018-2019",5,3,1,33.3,2,66.7,22,9,15,7,0,12,17,70.6,5,15,14,1,22,44,81,0,25,24,51,"DF"
"Luca Strizzolo","2018-2019",124,12,3,25,9,75,15,11,4,7,4,4,13,30.8,9,16,0,16,7,22,18,0,91,108,45.7,"FW"
"Marco Mancosu","2018-2019",265,49,24,49,25,51,29,22,13,13,3,11,36,30.6,25,21,5,16,8,37,17,0,25,38,39.7,"MF"
"Luca Bittante","2018-2019",69,14,3,21.4,11,78.6,15,11,8,5,2,5,14,35.7,9,12,3,9,13,28,34,0,11,15,42.3,"DF"
"Mirko Bruccini","2018-2019",114,24,10,41.7,14,58.3,43,27,15,23,5,11,53,20.8,42,39,4,35,28,71,42,0,23,26,46.9,"MF"
"Róbert Mazáň","2018-2019",20,5,1,20,4,80,12,10,7,4,1,5,11,45.5,6,6,0,6,8,20,8,0,6,4,60,"DF"
"Raffaele Pucino","2018-2019",38,9,7,77.8,2,22.2,28,18,17,9,2,18,25,72,7,23,10,13,30,58,54,0,47,19,71.2,"DF"
"Leonardo Mancuso","2018-2019",245,43,19,44.2,24,55.8,10,6,5,4,1,1,27,3.7,26,18,2,16,14,24,29,0,68,115,37.2,"FW"
"Zinédine Machach","2018-2019",98,85,40,47.1,43,50.6,15,12,3,7,5,2,10,20,8,8,0,8,3,18,1,0,6,36,14.3,"FW"
"Luca Clemenza","2018-2019",80,32,19,59.4,13,40.6,12,7,5,7,0,3,18,16.7,15,18,3,15,7,19,9,0,4,8,33.3,"FW,MF"
"Christian Maggio","2018-2019",45,10,5,50,5,50,33,17,18,12,3,15,32,46.9,17,20,10,10,28,61,29,0,23,21,52.3,"DF"
"Riccardo Brosco","2018-2019",11,10,7,70,3,30,32,22,23,7,2,11,21,52.4,10,34,18,16,58,90,182,0,152,51,74.9,"DF"
"Andrea Barberis","2018-2019",65,12,11,91.7,1,8.3,48,32,17,25,6,12,40,30,28,38,10,28,58,106,29,0,27,18,60,"MF"
"Valerio Verre","2018-2019",203,57,37,64.9,19,33.3,45,29,12,31,2,13,33,39.4,20,33,7,26,32,77,26,0,12,29,29.3,"MF"
"Marco Migliorini","2018-2019",1,3,3,100,0,0,20,15,17,3,0,8,16,50,8,19,13,6,37,57,125,2,52,16,76.5,"DF"
"Francesco Di Mariano","2018-2019",225,26,14,53.8,12,46.2,16,13,11,3,2,6,16,37.5,10,17,5,12,8,24,18,0,11,41,21.2,"FW"
"Mattia Viviani","2018-2019",1,2,2,100,0,0,9,6,4,4,1,2,7,28.6,5,4,0,4,1,10,6,0,6,3,66.7,"MF"
"Dario Dainelli","2018-2019",3,6,6,100,0,0,13,7,9,3,1,6,20,30,14,19,10,9,42,55,120,0,40,23,63.5,"DF"
"Marco Crimi","2018-2019",57,13,5,38.5,8,61.5,41,31,18,20,3,10,28,35.7,18,18,1,17,15,56,13,0,18,26,40.9,"MF"
"Ivaylo Chochev","2018-2019",26,7,5,71.4,2,28.6,19,18,5,11,3,3,11,27.3,8,18,2,16,17,36,18,0,10,11,47.6,"MF"
"Luca Palmiero","2018-2019",18,29,19,65.5,10,34.5,73,52,25,41,7,25,80,31.3,55,26,1,25,39,112,23,0,14,18,43.8,"MF"
"Jacopo Segre","2018-2019",64,24,15,62.5,9,37.5,38,27,7,24,7,11,22,50,11,21,5,16,21,59,28,0,26,39,40,"MF"
"Matteo Ricci","2018-2019",24,17,15,88.2,2,11.8,72,50,39,29,4,23,70,32.9,47,44,8,36,57,129,37,0,24,30,44.4,"MF"
"Gaetano Letizia","2018-2019",126,49,28,57.1,20,40.8,48,30,33,10,5,20,30,66.7,10,25,2,23,33,81,47,0,31,17,64.6,"DF"
"Carlos Apna Embaló","2018-2019",72,34,24,70.6,10,29.4,12,8,6,5,1,3,7,42.9,4,5,0,5,4,16,2,0,10,21,32.3,"FW,MF"
"Luca Ghiringhelli","2018-2019",119,16,5,31.3,11,68.8,28,16,17,7,4,11,20,55,9,31,9,22,46,74,91,0,27,24,52.9,"DF"
"Milan Đurić","2018-2019",124,12,7,58.3,5,41.7,5,2,3,1,1,1,7,14.3,6,8,2,6,2,7,21,0,162,72,69.2,"FW"
"Haitam Aleesami","2018-2019",167,39,21,53.8,18,46.2,30,19,13,11,6,15,29,51.7,14,23,6,17,31,61,48,0,24,27,47.1,"DF"
"Lucas Chiaretti","2018-2019",87,21,11,52.4,10,47.6,11,8,2,5,4,3,6,50,3,5,0,5,8,19,3,0,7,17,29.2,"MF,FW"
"Maecky Ngombo","2018-2019",54,6,3,50,3,50,3,2,0,2,1,1,4,25,3,5,2,3,0,3,3,0,10,23,30.3,"FW"
"Matija Boben","2018-2019",2,6,2,33.3,4,66.7,28,20,17,11,0,10,12,83.3,2,6,3,3,19,47,31,0,14,9,60.9,"DF"
"Lorenzo Rosseti","2018-2019",81,17,8,47.1,9,52.9,13,7,4,8,1,2,7,28.6,5,23,2,21,2,15,5,0,28,74,27.5,"FW"
"Stefano Scappini","2018-2019",57,1,0,0,1,100,3,2,0,2,1,0,3,0,3,2,1,1,2,5,3,0,19,28,40.4,"FW"
"Dennis Iapichino","2018-2019",26,8,6,75,2,25,9,6,5,3,1,4,5,80,1,1,1,0,11,20,17,0,3,6,33.3,"DF"
"Luca Mora","2018-2019",90,22,14,63.6,8,36.4,46,35,21,20,5,13,38,34.2,25,22,4,18,22,68,52,0,61,58,51.3,"MF"
"Antonio Di Gaudio","2018-2019",98,25,11,44,14,56,6,2,2,3,1,1,13,7.7,12,11,0,11,5,11,2,0,0,16,0,"FW,MF"
"Antonio Mazzotta","2018-2019",57,12,4,33.3,8,66.7,9,9,7,2,0,3,7,42.9,4,9,1,8,5,14,10,0,3,3,50,"DF,MF"
"Federico Proia","2018-2019",39,14,9,64.3,5,35.7,42,28,20,19,3,11,36,30.6,25,22,2,20,14,56,6,0,15,16,48.4,"MF"
"Adrian Stoian","2018-2019",78,22,20,90.9,2,9.1,6,3,0,3,3,3,9,33.3,6,12,3,9,4,10,3,0,4,5,44.4,"FW,MF"
"Gianluca Litteri","2018-2019",44,4,3,75,1,25,3,1,0,3,0,0,6,0,6,2,0,2,2,5,5,0,21,34,38.2,"FW"
"Nicolas Viola","2018-2019",50,34,21,61.8,13,38.2,46,30,16,21,9,18,32,56.3,14,17,5,12,26,72,17,0,9,7,56.3,"MF"
"Mauro Coppolaro","2018-2019",6,7,6,85.7,1,14.3,20,14,14,6,0,8,14,57.1,6,15,8,7,14,34,84,0,28,18,60.9,"DF"
"Emanuele Ndoj","2018-2019",128,75,47,62.7,28,37.3,79,56,28,39,12,18,52,34.6,34,31,6,25,22,101,25,0,38,31,55.1,"MF"
"Alessandro Bruno","2018-2019",20,8,6,75,2,25,46,35,20,20,6,17,32,53.1,15,25,11,14,30,76,36,0,26,21,55.3,"MF"
"Andrew Gravillon","2018-2019",6,9,7,77.8,2,22.2,39,28,29,10,0,21,29,72.4,8,46,32,14,38,77,140,1,40,47,46,"DF"
"Andrea Arrigoni","2018-2019",6,7,6,85.7,1,14.3,19,12,13,6,0,10,15,66.7,5,6,5,1,27,46,29,0,13,8,61.9,"MF"
"Alessandro Buongiorno","2018-2019",9,7,3,42.9,4,57.1,21,15,15,5,1,10,19,52.6,9,14,10,4,30,51,54,0,31,17,64.6,"DF"
"Andrea Schiavone","2018-2019",11,12,9,75,3,25,30,19,15,10,5,13,40,32.5,27,13,2,11,29,59,19,0,10,19,34.5,"MF"
"Alessio Sabbione","2018-2019",19,33,21,63.6,11,33.3,56,44,36,18,2,22,47,46.8,25,38,23,15,58,114,110,0,79,55,59,"DF,MF"
"Mirko Carretta","2018-2019",125,27,16,59.3,10,37,9,7,6,2,1,5,9,55.6,4,5,0,5,6,15,2,0,10,50,16.7,"FW,MF"
"Massimo Coda","2018-2019",245,50,26,52,24,48,16,12,0,8,8,3,16,18.8,13,14,1,13,3,19,12,1,95,157,37.7,"FW"
"Pietro Ceccaroni","2018-2019",18,5,3,60,2,40,15,11,10,5,0,7,10,70,3,17,9,8,16,31,40,0,9,9,50,"DF"
"Angelo Corsi","2018-2019",81,31,16,51.6,15,48.4,40,28,20,13,7,20,36,55.6,16,26,5,21,27,67,48,0,6,6,50,"DF"
"Riccardo Bocalon","2018-2019",125,15,10,66.7,5,33.3,11,6,0,7,4,2,13,15.4,11,12,2,10,7,18,21,0,64,109,37,"FW"
"Agostino Camigliano","2018-2019",2,2,1,50,1,50,14,10,7,5,2,3,3,100,0,4,1,3,18,32,35,0,20,18,52.6,"DF"
"Federico Ricci","2018-2019",111,37,17,45.9,20,54.1,28,20,11,12,5,8,18,44.4,10,18,0,18,6,34,2,0,3,17,15,"MF,FW"
"Michele Cremonesi","2018-2019",3,2,0,0,2,100,8,7,5,3,0,4,6,66.7,2,16,10,6,28,36,78,0,51,11,82.3,"DF"
"Salvatore Molina","2018-2019",108,15,10,66.7,5,33.3,37,26,23,12,2,13,30,43.3,17,22,11,11,14,51,27,1,19,23,45.2,"MF,DF"
"Claudio Terzi","2018-2019",2,2,2,100,0,0,38,29,28,8,2,14,28,50,14,31,18,13,59,97,174,1,73,67,52.1,"DF"
"Alfredo Donnarumma","2018-2019",313,29,15,51.7,14,48.3,14,10,2,7,5,2,8,25,6,10,2,8,4,18,7,0,20,43,31.7,"FW"
"Valerio Mantovani","2018-2019",5,2,2,100,0,0,36,25,22,14,0,11,21,52.4,10,25,13,12,62,98,110,0,55,35,61.1,"DF"
"Antonio Marino","2018-2019",12,2,1,50,1,50,10,9,6,4,0,2,6,33.3,4,6,1,5,14,24,55,0,28,13,68.3,"DF"
"Luca Martinelli","2018-2019",14,11,6,54.5,5,45.5,24,16,16,7,1,9,21,42.9,12,35,23,12,47,71,160,2,54,39,58.1,"DF"
"Anderson Lima","2018-2019",58,29,18,62.1,11,37.9,13,11,4,9,0,3,13,23.1,10,8,0,8,6,19,3,0,5,12,29.4,"MF,FW"
"Vasile Mogos","2018-2019",106,35,24,68.6,11,31.4,38,31,26,10,2,15,36,41.7,21,35,13,22,66,104,93,0,80,44,64.5,"DF"
"Salvatore D'Elia","2018-2019",52,18,13,72.2,5,27.8,25,18,17,6,2,10,17,58.8,7,14,5,9,18,43,50,0,6,9,40,"DF"
"Manuel Marras","2018-2019",256,28,16,57.1,12,42.9,41,31,18,17,6,12,50,24,38,28,0,28,31,72,3,0,10,12,45.5,"FW,MF"
"Massimiliano Busellato","2018-2019",91,15,10,66.7,5,33.3,55,28,23,24,8,26,57,45.6,31,20,2,18,20,75,17,0,7,9,43.8,"MF"
"Marco Firenze","2018-2019",197,13,5,38.5,8,61.5,20,15,8,11,1,7,17,41.2,10,10,1,9,15,35,17,0,12,14,46.2,"DF,MF"
"Andrés Tello","2018-2019",61,22,15,68.2,7,31.8,54,40,19,23,12,16,58,27.6,42,42,7,35,48,102,29,0,24,17,58.5,"MF"
"Paolo Bartolomei","2018-2019",124,30,18,60,12,40,37,29,14,18,5,11,33,33.3,22,23,6,17,19,56,24,0,12,18,40,"MF"
"Marco Calderoni","2018-2019",221,25,8,32,17,68,42,29,21,18,3,18,27,66.7,9,21,3,18,39,81,69,0,23,25,47.9,"DF"
"Andrea Nalini","2018-2019",90,4,4,100,0,0,6,5,0,4,2,0,4,0,4,10,1,9,2,8,0,0,18,27,40,"FW,MF"
"Filippo Melegoni","2018-2019",40,6,3,50,3,50,13,10,5,7,1,0,7,0,7,6,2,4,6,19,6,0,6,10,37.5,"MF"
"Claiton","2018-2019",3,2,1,50,1,50,27,20,13,14,0,10,17,58.8,7,26,20,6,46,73,155,0,55,48,53.4,"DF"
"Umar Sadiq","2018-2019",106,41,32,78,9,22,11,9,3,6,2,2,7,28.6,5,7,1,6,1,12,9,0,26,64,28.9,"FW"
"Riccardo Serena","2018-2019",12,4,3,75,1,25,4,2,2,2,0,2,7,28.6,5,6,1,5,15,19,15,0,9,11,45,"MF"
"Gianluca Di Chiara","2018-2019",24,12,10,83.3,2,16.7,30,25,16,13,1,11,22,50,11,19,5,14,31,61,48,0,12,9,57.1,"DF"
"Simone Pasa","2018-2019",21,10,8,80,2,20,10,6,5,5,0,3,10,30,7,7,5,2,8,18,8,0,9,9,50,"MF"
"Raúl Asencio","2018-2019",46,14,7,50,7,50,1,1,0,1,0,0,1,0,1,6,1,5,5,6,9,0,53,40,57,"FW,MF"
"Gabriele Gori","2018-2019",30,6,2,33.3,4,66.7,3,3,0,2,1,0,4,0,4,0,0,0,0,3,7,0,20,29,40.8,"FW"
"Giampaolo Pazzini","2018-2019",87,6,2,33.3,4,66.7,1,1,1,0,0,0,4,0,4,3,0,3,3,4,8,0,24,26,48,"FW,MF"
"Danilo Quaranta","2018-2019",4,5,4,80,1,20,4,3,1,3,0,2,3,66.7,1,4,3,1,11,15,22,0,13,8,61.9,"DF"
"Cesare Bovo","2018-2019",4,2,1,50,1,50,7,2,4,1,2,3,3,100,0,3,3,0,16,23,25,0,9,6,60,"DF"
"Soufiane Bidaoui","2018-2019",167,52,34,65.4,18,34.6,13,7,5,7,1,5,9,55.6,4,8,1,7,7,20,5,0,3,17,15,"FW,MF"
"Tommaso D'Orazio","2018-2019",119,43,15,34.9,28,65.1,41,31,16,18,7,16,36,44.4,20,21,1,20,34,75,41,0,42,33,56,"DF"
"Lamin Jallow","2018-2019",273,79,48,60.8,31,39.2,20,15,6,11,3,0,20,0,20,11,0,11,8,28,7,0,18,71,20.2,"FW,MF"
"Marcello Falzerano","2018-2019",186,59,47,79.7,12,20.3,44,34,22,15,7,12,31,38.7,19,23,1,22,15,59,27,1,16,22,42.1,"MF"
"Antonio Porcino","2018-2019",114,26,12,46.2,14,53.8,33,22,13,16,4,9,21,42.9,12,11,0,11,13,46,28,0,4,12,25,"DF,MF"
"Ryder Matos","2018-2019",208,45,28,62.2,17,37.8,17,14,6,8,3,1,5,20,4,10,2,8,5,22,6,0,8,31,20.5,"FW,MF"
"Nicholas Siega","2018-2019",93,21,11,52.4,10,47.6,30,22,11,14,5,9,23,39.1,14,29,3,26,13,43,6,0,16,28,36.4,"MF"
"Niccolò Zanellato","2018-2019",55,5,5,100,0,0,32,23,14,13,5,5,13,38.5,8,9,3,6,19,51,15,0,46,19,70.8,"MF"
"Daniel Cappelletti","2018-2019",55,22,13,59.1,9,40.9,59,39,33,24,2,22,37,59.5,15,32,10,22,54,113,108,0,106,53,66.7,"DF,MF"
"Francesco Deli","2018-2019",116,73,36,49.3,37,50.7,36,26,16,15,5,11,28,39.3,17,13,3,10,4,40,15,0,17,25,40.5,"MF"
"Tiago Casasola","2018-2019",191,35,22,62.9,13,37.1,41,26,22,11,8,21,40,52.5,19,25,6,19,41,82,61,0,25,24,51,"DF"
"Simone Bentivoglio","2018-2019",38,6,4,66.7,2,33.3,28,17,18,9,1,9,20,45,11,14,5,9,29,57,37,0,26,28,48.1,"MF"
"Pepín","2018-2019",71,38,26,68.4,12,31.6,30,22,12,12,6,11,39,28.2,28,12,2,10,17,47,8,0,9,24,27.3,"MF"
"Stefano Moreo","2018-2019",154,36,20,55.6,16,44.4,13,8,6,3,4,3,9,33.3,6,16,3,13,9,22,26,0,98,104,48.5,"FW"
"Nicholas Pierini","2018-2019",118,28,16,57.1,12,42.9,14,8,6,8,0,5,14,35.7,9,8,1,7,2,16,6,0,13,20,39.4,"FW"
"Nicola Falasco","2018-2019",44,10,7,70,3,30,27,20,16,8,3,17,28,60.7,11,9,0,9,15,42,30,0,6,10,37.5,"DF"
"Cristian Galano","2018-2019",96,29,21,72.4,8,27.6,7,6,1,4,2,1,8,12.5,7,8,2,6,3,10,1,0,8,14,36.4,"FW,MF"
"Giuseppe Bellusci","2018-2019",6,14,9,64.3,5,35.7,42,27,25,15,2,17,39,43.6,22,29,17,12,44,86,140,2,88,47,65.2,"DF"
"Ledian Memushaj","2018-2019",151,60,39,65,20,33.3,37,24,11,24,2,11,34,32.4,23,21,8,13,32,69,26,0,28,29,49.1,"MF"
"Simeon Nwankwo","2018-2019",183,35,23,65.7,12,34.3,5,4,0,2,3,1,9,11.1,8,19,7,12,3,8,24,0,48,70,40.7,"FW"
"Domenico Mungo","2018-2019",63,29,15,51.7,14,48.3,70,46,28,35,7,25,58,43.1,33,30,5,25,38,108,14,0,8,24,25,"MF,FW"
"Jerry Mbakogu","2018-2019",61,17,6,35.3,11,64.7,4,3,0,2,2,0,3,0,3,1,0,1,1,5,9,0,28,36,43.8,"FW"
"Maurizio Domizzi","2018-2019",8,7,5,71.4,2,28.6,47,38,33,12,2,24,40,60,16,25,16,9,47,94,136,0,64,41,61,"DF"
"Alan Empereur","2018-2019",8,7,6,85.7,1,14.3,10,6,7,2,1,2,4,50,2,15,12,3,24,34,47,0,23,17,57.5,"DF"
"Francesco Valiani","2018-2019",133,24,12,50,12,50,34,26,11,19,4,10,30,33.3,20,27,3,24,23,57,69,0,15,20,42.9,"DF,MF"
"Nicolò Fazzi","2018-2019",70,20,8,40,12,60,22,16,10,7,5,7,12,58.3,5,15,1,14,14,36,30,0,19,12,61.3,"DF"
"Han Kwang-song","2018-2019",101,26,15,57.7,11,42.3,11,9,1,6,4,2,9,22.2,7,5,0,5,3,14,10,0,9,19,32.1,"FW"
"Federico Melchiorri","2018-2019",173,33,20,60.6,12,36.4,29,22,12,10,7,4,7,57.1,3,20,2,18,6,35,19,0,42,45,48.3,"FW"
"Nicolò Cherubin","2018-2019",0,1,1,100,0,0,9,2,6,3,0,5,6,83.3,1,14,7,7,15,24,76,0,27,12,69.2,"DF"
"Felipe Curcio","2018-2019",40,22,15,68.2,7,31.8,21,11,13,8,0,7,14,50,7,9,1,8,20,41,37,0,19,5,79.2,"DF"
"Gennaro Tutino","2018-2019",295,98,39,39.8,59,60.2,8,5,3,2,3,3,11,27.3,8,15,0,15,5,13,12,0,48,61,44,"FW,MF"
"Davide Agazzi","2018-2019",49,26,16,61.5,10,38.5,87,63,34,45,8,27,62,43.5,35,36,3,33,42,129,30,0,14,19,42.4,"MF"
"Daniele Sciaudone","2018-2019",55,22,11,50,11,50,28,15,16,10,2,10,22,45.5,12,22,2,20,16,44,10,0,12,12,50,"MF"
"Luca Ranieri","2018-2019",44,19,9,47.4,10,52.6,28,19,18,7,3,14,29,48.3,15,23,13,10,37,65,125,0,48,30,61.5,"DF"
"Giovanni Crociata","2018-2019",36,21,10,47.6,10,47.6,9,7,4,3,2,3,12,25,9,7,1,6,1,10,7,0,6,5,54.5,"MF"
"Emanuele Terranova","2018-2019",2,11,10,90.9,1,9.1,15,12,9,6,0,10,12,83.3,2,25,20,5,50,65,143,0,76,41,65,"DF"
"Mattia Vitale","2018-2019",19,15,8,53.3,7,46.7,23,18,14,6,3,13,39,33.3,26,10,0,10,7,30,10,0,4,6,40,"MF"
"Fabio Lucioni","2018-2019",3,7,4,57.1,3,42.9,19,10,14,5,0,6,12,50,6,25,18,7,49,68,124,0,52,22,70.3,"DF"
"Roberto Insigne","2018-2019",161,39,15,38.5,24,61.5,7,4,2,3,2,1,13,7.7,12,7,0,7,5,12,4,0,1,27,3.6,"FW,MF"
"Giacomo Beretta","2018-2019",183,28,16,57.1,12,42.9,19,16,3,13,3,0,7,0,7,9,2,7,3,22,14,0,30,54,35.7,"FW"
"Jacopo Petriccione","2018-2019",76,22,10,45.5,12,54.5,58,43,15,39,4,30,63,47.6,33,33,4,29,30,88,22,0,26,24,52,"MF"
"Marco Perrotta","2018-2019",3,1,1,100,0,0,21,13,13,7,1,11,18,61.1,7,12,7,5,22,43,80,0,41,26,61.2,"DF"
"Mirko Antonucci","2018-2019",110,14,3,21.4,11,78.6,24,17,10,11,3,6,12,50,6,15,3,12,7,31,2,0,2,5,28.6,"FW"
"Tobias Pachonik","2018-2019",63,50,29,58,21,42,48,43,33,10,5,16,25,64,9,24,11,13,21,69,86,0,28,27,50.9,"DF"
"Riccardo Marchizza","2018-2019",13,5,3,60,2,40,12,10,8,4,0,3,8,37.5,5,13,6,7,25,37,45,0,18,14,56.3,"DF"
"Nicola Citro","2018-2019",50,13,7,53.8,6,46.2,8,7,5,1,2,3,10,30,7,6,1,5,11,19,5,0,3,17,15,"FW,MF"
"Michele Rocca","2018-2019",46,22,14,63.6,8,36.4,17,10,7,9,1,6,15,40,9,9,2,7,12,29,16,0,14,15,48.3,"MF"
"Marco Armellino","2018-2019",16,7,5,71.4,2,28.6,11,5,4,7,0,7,13,53.8,6,4,1,3,6,17,5,0,5,9,35.7,"MF"
"Riccardo Sottil","2018-2019",63,16,10,62.5,6,37.5,3,2,1,2,0,1,4,25,3,4,0,4,2,5,2,0,2,7,22.2,"FW"
"Matteo Ardemagni","2018-2019",116,12,4,33.3,8,66.7,5,3,0,4,1,0,14,0,14,9,2,7,6,11,14,0,39,94,29.3,"FW"
"Matteo Legittimo","2018-2019",35,19,12,63.2,7,36.8,40,32,28,10,2,16,23,69.6,7,24,12,12,43,83,85,0,16,17,48.5,"DF"
"Giulio Maggiore","2018-2019",45,12,6,50,5,41.7,18,13,10,8,0,6,15,40,9,14,2,12,9,27,10,0,25,27,48.1,"MF"
"Denis Tonucci","2018-2019",5,3,3,100,0,0,7,5,6,1,0,4,8,50,4,7,7,0,13,20,49,0,24,15,61.5,"DF"
"Slobodan Rajković","2018-2019",9,3,2,66.7,1,33.3,40,32,24,14,2,12,25,48,13,30,26,4,44,84,121,0,113,50,69.3,"DF"
"Emanuele Suagher","2018-2019",5,1,0,0,1,100,5,2,5,0,0,3,10,30,7,22,16,6,13,18,67,0,26,12,68.4,"DF"
"Luca Antei","2018-2019",1,4,1,25,3,75,31,23,25,4,2,12,19,63.2,7,16,12,4,45,76,84,0,27,17,61.4,"DF"
"Lorenzo Venuti","2018-2019",140,25,11,44,14,56,55,37,36,18,1,24,41,58.5,17,23,5,18,32,87,71,0,18,17,51.4,"DF"
"Andrea Mazzarani","2018-2019",43,5,4,80,1,20,4,4,2,1,1,2,4,50,2,1,0,1,9,13,4,0,4,7,36.4,"MF,FW"
"Antonio Caracciolo","2018-2019",11,5,4,80,1,20,35,25,25,9,1,11,15,73.3,4,33,17,16,46,81,114,1,36,25,59,"DF"
"Filippo De Col","2018-2019",79,7,3,42.9,4,57.1,6,6,2,1,3,3,7,42.9,4,11,6,5,16,22,38,0,15,19,44.1,"DF"
"Nicolás Spolli","2018-2019",3,3,3,100,0,0,11,9,8,3,0,5,6,83.3,1,11,9,2,26,37,73,0,14,7,66.7,"DF"
"Davide Diaw","2018-2019",52,16,7,43.8,9,56.3,12,9,0,8,4,0,6,0,6,12,1,11,6,18,17,0,21,22,48.8,"FW"
"Przemysław Szymiński","2018-2019",18,6,3,50,3,50,13,8,7,6,0,5,12,41.7,7,13,6,7,28,41,56,0,43,30,58.9,"DF"
"Luca Fiordilino","2018-2019",21,6,3,50,3,50,17,9,8,7,2,5,10,50,5,12,2,10,7,24,6,0,4,6,40,"MF"
"Samuel Armenteros","2018-2019",54,21,11,52.4,10,47.6,7,6,1,2,4,1,5,20,4,1,0,1,0,7,0,0,8,24,25,"FW"
"Raffaele Schiavi","2018-2019",0,1,1,100,0,0,11,6,9,2,0,8,10,80,2,17,12,5,13,24,74,0,25,13,65.8,"DF"
"Yves Baraye","2018-2019",66,57,37,64.9,20,35.1,23,18,11,6,6,12,20,60,8,13,1,12,6,29,10,0,15,12,55.6,"FW,MF"
"Simone Calvano","2018-2019",8,10,8,80,2,20,18,14,7,9,2,5,14,35.7,9,16,9,7,38,56,24,0,46,32,59,"MF"
"Marco Pinato","2018-2019",73,11,6,54.5,5,45.5,30,28,14,13,3,4,15,26.7,11,19,3,16,13,43,20,0,35,41,46.1,"MF"
"Nikolas Špalek","2018-2019",180,37,20,54.1,17,45.9,28,17,12,10,6,6,34,17.6,28,15,0,15,11,39,5,0,10,26,27.8,"MF,FW"
"Fabio Mazzeo","2018-2019",200,15,7,46.7,8,53.3,11,9,6,3,2,4,13,30.8,9,6,1,5,2,13,13,0,33,54,37.9,"FW"
"Riccardo Fiamozzi","2018-2019",37,13,2,15.4,11,84.6,10,6,5,1,4,4,9,44.4,5,5,3,2,11,21,23,0,2,10,16.7,"DF"
"Ahmad Benali","2018-2019",68,24,16,66.7,8,33.3,37,27,13,21,3,13,41,31.7,28,26,7,19,35,72,14,1,14,16,46.7,"MF"
"Jean-Claude Billong","2018-2019",3,9,8,88.9,1,11.1,34,24,25,8,1,9,21,42.9,12,23,18,5,22,56,144,2,49,36,57.6,"DF"
"Guillaume Gigliotti","2018-2019",9,12,7,58.3,5,41.7,26,21,14,11,1,15,27,55.6,12,33,16,17,34,60,95,0,29,14,67.4,"DF"
"Antonio Balzano","2018-2019",130,40,23,57.5,17,42.5,65,50,40,15,10,19,35,54.3,16,24,5,19,48,113,54,0,14,11,56,"DF"
"Mattia Finotto","2018-2019",217,32,17,53.1,15,46.9,8,6,1,3,4,2,7,28.6,5,14,5,9,5,13,18,0,40,44,47.6,"FW"
"Nikola Ninković","2018-2019",202,68,30,44.1,38,55.9,29,23,3,16,10,4,19,21.1,15,12,1,11,15,44,10,0,7,19,26.9,"MF,FW"
"Moses Odjer","2018-2019",13,7,4,57.1,3,42.9,12,6,4,7,1,4,10,40,6,10,3,7,12,24,8,0,4,8,33.3,"MF"
"Gabriel Strefezza","2018-2019",156,56,33,58.9,23,41.1,23,20,12,7,4,3,12,25,9,16,1,15,9,32,4,0,6,25,19.4,"MF,FW"
"Michele Castagnetti","2018-2019",11,9,6,66.7,3,33.3,40,26,20,17,3,18,33,54.5,15,15,9,6,26,66,30,0,12,14,46.2,"MF"
"Santiago Colombatto","2018-2019",26,18,9,50,9,50,14,10,3,10,1,4,17,23.5,13,12,3,9,22,36,18,0,7,16,30.4,"MF"
"Andrea Brighenti","2018-2019",72,5,3,60,2,40,4,2,1,3,0,1,4,25,3,3,0,3,3,7,10,0,12,20,37.5,"FW"
"Mattia Mustacchio","2018-2019",108,26,11,42.3,15,57.7,12,11,7,3,2,6,19,31.6,13,7,0,7,4,16,14,0,6,28,17.6,"FW,DF"
"Ľubomír Tupta","2018-2019",73,15,8,53.3,7,46.7,4,3,2,0,2,1,5,20,4,7,1,6,2,6,5,0,5,13,27.8,"FW,MF"
"Andrea Luci","2018-2019",21,21,16,76.2,5,23.8,51,38,25,23,3,23,49,46.9,26,40,15,25,49,100,31,0,28,17,62.2,"MF"
"Cristiano Del Grosso","2018-2019",89,4,4,100,0,0,33,20,22,7,4,21,34,61.8,13,22,11,11,31,64,79,0,19,18,51.4,"DF"
"Marco Carraro","2018-2019",7,16,13,81.3,3,18.8,50,36,24,25,1,20,35,57.1,15,33,15,18,39,89,58,0,23,20,53.5,"MF"
"Samuel Gustafson","2018-2019",48,18,13,72.2,5,27.8,31,20,12,17,2,9,29,31,20,25,10,15,29,60,29,0,28,28,50,"MF"
"Karamoko Cissé","2018-2019",57,17,9,52.9,8,47.1,15,14,3,5,7,3,4,75,1,5,1,4,5,20,17,0,23,37,38.3,"FW,MF"
"Gabriele Rolando","2018-2019",49,27,15,55.6,12,44.4,19,11,10,8,1,9,24,37.5,15,14,5,9,9,28,25,1,11,23,32.4,"DF,MF"
"Matteo Bianchetti","2018-2019",47,13,7,53.8,6,46.2,28,21,20,5,3,9,15,60,6,22,15,7,39,67,61,0,43,19,69.4,"DF"
"Mirko Drudi","2018-2019",5,8,7,87.5,1,12.5,47,34,25,21,1,15,34,44.1,19,21,11,10,57,104,91,0,49,30,62,"DF"
"Manuel Iori","2018-2019",42,15,11,73.3,4,26.7,39,28,20,13,6,13,30,43.3,17,22,11,11,40,79,44,1,44,40,52.4,"MF"
"Luca Castiglia","2018-2019",40,3,3,100,0,0,14,10,7,4,3,1,5,20,4,14,3,11,12,26,31,0,15,9,62.5,"MF"
"Andrea Tabanelli","2018-2019",70,34,21,61.8,13,38.2,35,21,14,13,8,11,24,45.8,13,20,4,16,16,51,22,0,45,35,56.3,"MF"
"Marcus Rohdén","2018-2019",150,26,20,76.9,6,23.1,31,17,8,20,3,14,37,37.8,23,18,4,14,24,55,9,0,15,36,29.4,"MF"
"Francesco Di Tacchio","2018-2019",24,23,16,69.6,7,30.4,71,59,35,35,1,13,58,22.4,45,50,6,44,61,132,56,0,129,45,74.1,"MF"
"Alessio da Cruz","2018-2019",85,48,40,83.3,8,16.7,4,2,2,2,0,0,3,0,3,5,1,4,5,9,0,0,3,10,23.1,"FW"
"Giammario Piscitella","2018-2019",59,36,15,41.7,20,55.6,12,9,9,3,0,2,10,20,8,3,1,2,7,19,9,0,5,12,29.4,"MF"
"Aljaž Struna","2018-2019",0,2,1,50,1,50,4,3,3,1,0,1,1,100,0,5,4,1,5,9,18,0,9,6,60,"DF"
"Enrico Pezzi","2018-2019",9,3,2,66.7,1,33.3,45,36,27,17,1,25,34,73.5,9,20,5,15,44,89,72,1,23,20,53.5,"DF"
"Michele Cavion","2018-2019",127,33,15,45.5,18,54.5,59,46,28,25,6,17,36,47.2,19,29,2,27,28,87,37,0,37,34,52.1,"MF"
"Amedeo Benedetti","2018-2019",169,33,21,63.6,12,36.4,46,35,30,16,0,23,40,57.5,17,36,13,23,38,84,64,0,4,17,19,"DF"
"Giuseppe Panico","2018-2019",104,10,1,10,9,90,13,10,5,4,4,1,8,12.5,7,14,0,14,9,22,2,0,9,32,22,"FW,MF"
"Andrea Schenetti","2018-2019",247,50,31,62,19,38,13,11,0,8,5,1,4,25,3,8,0,8,8,21,6,0,9,22,29,"MF"
"Lorenzo Gonnelli","2018-2019",9,5,3,60,2,40,37,24,26,9,2,12,24,50,12,26,9,17,38,75,103,1,69,30,69.7,"DF"
"Davide Marsura","2018-2019",121,37,26,70.3,11,29.7,28,15,12,12,4,7,24,29.2,17,13,1,12,3,31,13,0,18,33,35.3,"MF,FW"
"Giovanni Di Noia","2018-2019",16,17,9,52.9,8,47.1,23,17,10,13,0,8,15,53.3,7,15,2,13,22,45,34,0,20,30,40,"MF"
"Agostino Garofalo","2018-2019",76,24,15,62.5,9,37.5,28,17,15,7,6,10,27,37,17,19,3,16,23,51,22,0,11,13,45.8,"DF"
"Žan Majer","2018-2019",30,10,8,80,2,20,14,11,4,8,2,8,21,38.1,13,14,4,10,5,19,7,0,2,5,28.6,"MF"
"Ernesto Torregrossa","2018-2019",268,69,48,69.6,21,30.4,18,13,7,6,5,6,19,31.6,13,21,7,14,10,28,24,0,78,83,48.4,"FW"
"Giacomo Vrioni","2018-2019",66,16,11,68.8,4,25,5,4,1,3,1,0,2,0,2,4,1,3,3,8,7,0,43,71,37.7,"FW,MF"
"Federico Bonazzoli","2018-2019",207,81,46,56.8,35,43.2,23,18,7,8,8,1,30,3.3,29,18,1,17,11,34,2,0,10,45,18.2,"FW"
"Marco Moscati","2018-2019",46,2,0,0,2,100,16,12,5,9,2,3,12,25,9,19,5,14,16,32,14,0,9,9,50,"MF,DF"
"Christian Kouan","2018-2019",25,11,6,54.5,5,45.5,15,13,6,5,4,5,12,41.7,7,12,3,9,9,24,6,0,8,11,42.1,"MF,FW"
"Maodo Malick Mbaye","2018-2019",7,9,5,55.6,4,44.4,23,18,14,8,1,6,17,35.3,11,10,2,8,32,55,12,0,58,45,56.3,"MF"
"Marco Zambelli","2018-2019",100,19,9,47.4,10,52.6,22,17,11,8,3,7,12,58.3,5,6,0,6,14,36,34,1,13,12,52,"DF"
"Luca Vignali","2018-2019",95,19,13,68.4,6,31.6,29,22,17,9,3,17,24,70.8,7,24,6,18,35,64,64,0,35,39,47.3,"DF,FW"
"George Pușcaș","2018-2019",172,35,14,40,21,60,5,3,0,2,3,0,2,0,2,4,3,1,6,11,16,0,41,44,48.2,"FW"
"Manuel Scavone","2018-2019",57,3,1,33.3,2,66.7,31,24,12,14,5,9,22,40.9,13,25,1,24,24,55,29,0,21,26,44.7,"MF"
"Andrea La Mantia","2018-2019",160,10,4,40,6,60,7,6,4,2,1,3,10,30,7,15,4,11,9,16,26,0,118,105,52.9,"FW"
"Gabriele Moncini","2018-2019",68,10,5,50,5,50,1,0,1,0,0,1,3,33.3,2,3,3,0,3,4,13,0,54,67,44.6,"FW"
"Murilo Otávio Mendes","2018-2019",179,45,23,51.1,22,48.9,17,13,7,6,4,3,10,30,7,16,2,14,10,27,15,0,29,54,34.9,"FW,MF"
"Luca Crecco","2018-2019",72,12,8,66.7,4,33.3,20,12,13,5,2,11,20,55,9,14,0,14,6,26,25,0,10,32,23.8,"MF"
"Mamadou Coulibaly","2018-2019",32,24,19,79.2,5,20.8,63,42,29,29,5,10,33,30.3,23,18,9,9,38,101,18,0,34,36,48.6,"MF"
"Djavan Anderson","2018-2019",71,31,15,48.4,16,51.6,12,5,2,6,4,2,4,50,2,13,0,13,17,29,19,0,6,9,40,"DF,MF"
"Alessandro Diamanti","2018-2019",263,87,53,60.9,34,39.1,26,18,7,10,9,5,27,18.5,22,14,2,12,2,28,8,0,5,11,31.3,"MF,FW"
"Luka Bogdan","2018-2019",6,3,2,66.7,1,33.3,39,27,23,14,2,13,20,65,7,24,13,11,51,90,120,0,50,25,66.7,"DF"
"Alessandro Rossi","2018-2019",33,5,3,60,2,40,3,2,2,0,1,1,1,100,0,1,0,1,0,3,4,0,6,28,17.6,"FW"
"Mario Sampirisi","2018-2019",107,14,10,71.4,4,28.6,30,25,18,8,4,10,25,40,15,25,14,11,59,89,93,0,45,24,65.2,"DF"
"Gennaro Scognamiglio","2018-2019",2,1,1,100,0,0,23,16,14,8,1,8,18,44.4,10,23,15,8,27,50,125,0,54,36,60,"DF"
"Simone Branca","2018-2019",210,40,31,77.5,9,22.5,79,55,29,39,11,25,78,32.1,53,44,7,37,29,108,26,0,24,47,33.8,"MF"
"Simone Palombi","2018-2019",137,12,2,16.7,10,83.3,7,5,4,3,0,2,16,12.5,14,4,0,4,2,9,6,0,7,20,25.9,"FW"
"David Okereke","2018-2019",225,41,26,63.4,14,34.1,21,18,9,9,3,6,15,40,9,11,1,10,11,32,8,0,38,60,38.8,"FW"
"Karim Laribi","2018-2019",179,26,14,53.8,11,42.3,21,15,8,10,3,2,18,11.1,16,10,1,9,15,36,10,0,5,17,22.7,"FW,MF"
"Riccardo Maniero","2018-2019",86,10,6,60,4,40,8,4,2,5,1,3,10,30,7,7,1,6,5,13,10,0,67,66,50.4,"FW"
"Sergio Contessa","2018-2019",39,10,4,40,6,60,7,6,7,0,0,3,4,75,1,8,1,7,20,27,27,0,14,16,46.7,"DF"
"Lorenzo Laverone","2018-2019",72,25,12,48,13,52,40,31,25,14,1,14,25,56,11,30,5,25,40,80,86,0,25,20,55.6,"DF"
"Nico Pulzetti","2018-2019",61,20,13,65,7,35,68,49,37,27,4,21,46,45.7,25,40,2,38,27,95,55,0,20,25,44.4,"MF,FW"
"Filippo Bandinelli","2018-2019",92,38,19,50,19,50,45,36,18,20,7,13,41,31.7,28,20,4,16,31,76,20,0,13,21,38.2,"MF"
"Fabio Concas","2018-2019",37,10,3,30,7,70,10,9,5,5,0,5,11,45.5,6,11,2,9,6,16,16,0,30,43,41.1,"MF,FW"
"Jacopo Dall'Oglio","2018-2019",75,8,4,50,4,50,21,18,7,11,3,11,20,55,9,14,4,10,11,32,7,1,13,19,40.6,"MF"
"Matteo Di Gennaro","2018-2019",6,13,9,69.2,3,23.1,59,45,42,15,2,14,30,46.7,16,46,27,19,82,141,197,0,85,46,64.9,"DF"
"Liam Henderson","2018-2019",98,7,2,28.6,5,71.4,14,8,2,10,2,3,14,21.4,11,26,4,22,10,24,14,0,9,17,34.6,"MF"
"Mattia Zaccagni","2018-2019",119,78,50,64.1,28,35.9,27,18,10,15,2,4,14,28.6,10,35,8,27,22,49,22,0,18,25,41.9,"MF"
"Leonardo Morosini","2018-2019",119,12,7,58.3,5,41.7,5,4,1,2,2,2,5,40,3,5,0,5,4,9,1,0,12,18,40,"FW"
"Matteo Ciofani","2018-2019",65,8,6,75,2,25,24,16,16,7,1,12,17,70.6,5,30,16,14,12,36,56,0,21,11,65.6,"DF"
"Alessandro Capello","2018-2019",137,32,14,43.8,18,56.3,33,22,12,16,5,11,28,39.3,17,19,5,14,9,42,29,0,21,63,25,"FW,MF"
"Niccolò Giannetti","2018-2019",112,23,10,43.5,13,56.5,19,13,2,12,5,2,6,33.3,4,6,1,5,4,23,14,0,38,62,38,"FW,MF"
"Cristian Agnelli","2018-2019",44,7,5,71.4,2,28.6,35,18,14,16,5,10,26,38.5,16,17,4,13,16,51,22,0,11,15,42.3,"MF"
"Aleš Matějů","2018-2019",89,13,9,69.2,4,30.8,48,37,30,16,2,18,27,66.7,9,29,7,22,37,85,49,0,22,20,52.4,"DF"
"Paulinho","2018-2019",49,14,7,50,7,50,2,2,2,0,0,1,2,50,1,4,0,4,2,4,6,0,27,20,57.4,"FW"
"Domenico Frare","2018-2019",1,2,1,50,1,50,31,26,12,16,3,13,20,65,7,13,11,2,40,71,72,0,27,23,54,"DF"
"Anton Krešić","2018-2019",0,5,4,80,1,20,19,12,13,6,0,8,13,61.5,5,25,21,4,18,37,81,1,61,24,71.8,"DF"
"Jaime Báez","2018-2019",194,51,25,49,26,51,21,14,9,5,7,7,21,33.3,14,16,0,16,8,29,9,0,11,20,35.5,"MF,FW"
"Mattia Zennaro","2018-2019",50,18,14,77.8,4,22.2,10,7,3,6,1,4,12,33.3,8,10,2,8,5,15,9,0,5,15,25,"MF"
"Filippo Falco","2018-2019",236,71,42,59.2,29,40.8,10,8,4,2,4,4,13,30.8,9,10,0,10,4,14,3,0,1,15,6.3,"FW,MF"
"Emanuele Calaiò","2018-2019",51,7,4,57.1,3,42.9,2,1,0,0,2,1,2,50,1,3,0,3,0,2,0,0,9,26,25.7,"FW"
"Davide Adorni","2018-2019",0,6,3,50,3,50,44,29,23,18,3,18,37,48.6,19,32,20,12,71,115,138,0,71,64,52.6,"DF"
"Giuseppe Zampano","2018-2019",83,28,20,71.4,8,28.6,40,27,25,13,2,20,31,64.5,11,20,5,15,15,55,45,0,12,21,36.4,"DF"
"Kingsley Michael","2018-2019",119,34,18,52.9,16,47.1,34,26,19,11,4,7,16,43.8,9,26,4,22,13,47,8,0,13,22,37.1,"MF"
"Alberto Gerbo","2018-2019",117,39,24,61.5,15,38.5,67,49,35,21,11,25,62,40.3,37,32,5,27,25,92,27,0,16,15,51.6,"MF,DF"
"Daniele Croce","2018-2019",37,19,13,68.4,6,31.6,26,18,16,9,1,11,27,40.7,16,14,1,13,18,44,17,0,3,8,27.3,"MF"
"GastÃ³n Brugman","2018-2019",92,42,30,71.4,12,28.6,88,62,42,37,9,25,66,37.9,41,48,10,38,54,142,28,0,17,6,73.9,"MF"
"Antonino Ragusa","2018-2019",74,25,9,36,16,64,19,16,12,6,1,8,12,66.7,4,9,0,9,8,27,6,0,2,9,18.2,"FW,MF"
"Luca Marrone","2018-2019",3,2,2,100,0,0,20,14,13,7,0,7,14,50,7,19,16,3,22,42,100,0,32,25,56.1,"DF"
"Luca Vido","2018-2019",227,54,38,70.4,16,29.6,23,18,8,10,5,11,22,50,11,17,1,16,6,29,18,0,22,44,33.3,"FW,MF"
"Pasquale Mazzocchi","2018-2019",83,55,32,58.2,23,41.8,35,27,24,5,6,17,33,51.5,16,17,4,13,26,61,59,2,20,18,52.6,"DF"
"Luca Tremolada","2018-2019",59,11,2,18.2,9,81.8,7,5,1,5,1,2,4,50,2,4,0,4,3,10,0,0,3,5,37.5,"MF,FW"
"Giuseppe Loiacono","2018-2019",14,5,3,60,2,40,33,26,16,14,3,16,23,69.6,7,14,12,2,14,47,83,0,29,26,52.7,"DF"
"Andrea Arrighini","2018-2019",163,21,7,33.3,14,66.7,2,1,0,0,2,1,5,20,4,2,0,2,2,4,9,0,32,71,31.1,"FW"
"Lorenzo Pasciuti","2018-2019",49,19,14,73.7,5,26.3,44,29,17,25,2,11,28,39.3,17,30,9,21,27,71,26,1,7,18,28,"MF"
"Cristiano Lombardi","2018-2019",81,30,20,66.7,10,33.3,19,16,6,11,2,6,25,24,19,14,1,13,11,30,8,0,9,11,45,"FW,DF"
"Giampietro Perrulli","2018-2019",67,19,11,57.9,8,42.1,6,6,1,3,2,1,4,25,3,6,0,6,4,10,8,0,1,2,33.3,"MF"
"Alberto Almici","2018-2019",32,3,1,33.3,2,66.7,18,16,10,6,2,8,11,72.7,3,13,4,9,16,34,35,0,8,6,57.1,"DF"
"Cristian Buonaiuto","2018-2019",128,30,19,63.3,11,36.7,31,20,11,15,5,8,31,25.8,23,12,1,11,17,48,11,0,13,23,36.1,"MF,FW"
"Reda Boultam","2018-2019",35,17,7,41.2,10,58.8,8,3,3,2,3,2,7,28.6,5,5,0,5,2,10,1,0,5,10,33.3,"MF"
"Francesco Renzetti","2018-2019",67,18,12,66.7,6,33.3,32,14,19,10,3,19,32,59.4,13,11,4,7,20,52,31,0,18,16,52.9,"DF"
"Lorenzo Crisetig","2018-2019",5,2,2,100,0,0,8,7,6,1,1,3,14,21.4,11,7,2,5,18,26,19,0,25,15,62.5,"MF"
"Mariano Arini","2018-2019",73,29,17,58.6,12,41.4,105,62,60,39,6,33,67,49.3,34,54,20,34,57,162,53,0,61,58,51.3,"MF"
"Riccardo Improta","2018-2019",174,46,24,52.2,22,47.8,29,22,11,11,7,6,19,31.6,13,20,1,19,29,58,26,1,16,26,38.1,"DF,FW"
"Jawad El Yamiq","2018-2019",6,4,3,75,1,25,26,24,21,4,1,13,16,81.3,3,19,14,5,28,54,73,0,33,20,62.3,"DF"
"Enej JeleniÄ","2018-2019",122,59,26,44.1,33,55.9,46,31,20,18,8,16,50,32,34,29,4,25,21,67,25,0,12,33,26.7,"MF"
"Michele Vano","2018-2019",37,8,2,25,6,75,6,6,4,1,1,1,7,14.3,6,6,1,5,2,8,4,0,53,46,53.5,"FW"
"Sergiu Suciu","2018-2019",29,8,6,75,2,25,17,6,8,7,2,2,8,25,6,7,1,6,23,40,19,1,5,4,55.6,"MF"
"Emmanuel Gyasi","2018-2019",200,30,23,76.7,7,23.3,21,13,9,10,2,6,12,50,6,12,0,12,10,31,3,0,15,25,37.5,"FW"
"Nicolas Haas","2018-2019",109,14,6,42.9,8,57.1,40,30,10,22,8,14,48,29.2,34,37,5,32,33,73,20,0,14,20,41.2,"MF"
"Alessandro Crescenzi","2018-2019",54,24,14,58.3,9,37.5,11,6,6,4,1,3,4,75,1,2,0,2,6,17,28,0,5,2,71.4,"DF"
"Bright Addae","2018-2019",62,20,14,70,6,30,29,20,13,14,2,14,36,38.9,22,23,5,18,36,65,74,0,81,63,56.3,"MF"
"Jean-Daniel Akpa-Akpro","2018-2019",37,43,26,60.5,17,39.5,83,62,42,35,6,22,34,64.7,12,41,4,37,27,110,25,0,21,15,58.3,"MF"
"Luigi Vitale","2018-2019",132,43,23,53.5,20,46.5,35,23,17,16,2,15,27,55.6,12,22,4,18,23,58,59,0,16,18,47.1,"DF"
"Andrea Cistana","2018-2019",3,14,12,85.7,2,14.3,36,24,31,5,0,19,28,67.9,9,31,25,6,29,65,128,1,53,44,54.6,"DF"
"Filip RaiÄeviÄ‡","2018-2019",132,29,17,58.6,12,41.4,6,5,1,4,1,1,7,14.3,6,9,4,5,2,8,14,0,92,94,49.5,"FW"
"Gian Filippo Felicioli","2018-2019",34,13,8,61.5,5,38.5,14,12,9,4,1,9,15,60,6,9,0,9,13,27,19,0,2,4,33.3,"DF"
"AnÃ­bal Capela","2018-2019",1,5,4,80,1,20,15,11,7,7,1,8,10,80,2,16,10,6,18,33,78,0,37,21,63.8,"DF"
